id,Geographic Area Name,TOT,NONBIPOC_TOT,BIPOC_TOT,BIPOC_PER,NONBIPOC_PER
36001000100,"Census Tract 1, Albany County, New York",2073,370,1703,0.82,0.18
36001000201,"Census Tract 2.01, Albany County, New York",3125,566,2559,0.82,0.18
36001000202,"Census Tract 2.02, Albany County, New York",2598,184,2414,0.93,0.07
36001000301,"Census Tract 3.01, Albany County, New York",3190,497,2693,0.84,0.16
36001000302,"Census Tract 3.02, Albany County, New York",3496,1916,1580,0.45,0.55
36001000401,"Census Tract 4.01, Albany County, New York",2216,1731,485,0.22,0.78
36001000403,"Census Tract 4.03, Albany County, New York",4418,2823,1595,0.36,0.64
36001000404,"Census Tract 4.04, Albany County, New York",5194,2897,2297,0.44,0.56
36001000501,"Census Tract 5.01, Albany County, New York",3440,1000,2440,0.71,0.29
36001000502,"Census Tract 5.02, Albany County, New York",2841,1562,1279,0.45,0.55
36001000600,"Census Tract 6, Albany County, New York",3500,844,2656,0.76,0.24
36001000700,"Census Tract 7, Albany County, New York",4196,494,3702,0.88,0.12
36001000800,"Census Tract 8, Albany County, New York",2216,306,1910,0.86,0.14
36001001100,"Census Tract 11, Albany County, New York",1826,875,951,0.52,0.48
36001001400,"Census Tract 14, Albany County, New York",3818,2490,1328,0.35,0.65
36001001500,"Census Tract 15, Albany County, New York",4528,2281,2247,0.5,0.5
36001001600,"Census Tract 16, Albany County, New York",4290,2399,1891,0.44,0.56
36001001700,"Census Tract 17, Albany County, New York",4016,2561,1455,0.36,0.64
36001001802,"Census Tract 18.02, Albany County, New York",3728,2602,1126,0.3,0.7
36001001803,"Census Tract 18.03, Albany County, New York",3232,2476,756,0.23,0.77
36001001804,"Census Tract 18.04, Albany County, New York",3473,2575,898,0.26,0.74
36001001901,"Census Tract 19.01, Albany County, New York",2514,1864,650,0.26,0.74
36001001902,"Census Tract 19.02, Albany County, New York",2566,1716,850,0.33,0.67
36001002000,"Census Tract 20, Albany County, New York",5960,2117,3843,0.64,0.36
36001002100,"Census Tract 21, Albany County, New York",3937,1767,2170,0.55,0.45
36001002200,"Census Tract 22, Albany County, New York",2299,1294,1005,0.44,0.56
36001002300,"Census Tract 23, Albany County, New York",2147,616,1531,0.71,0.29
36001002500,"Census Tract 25, Albany County, New York",3208,482,2726,0.85,0.15
36001002600,"Census Tract 26, Albany County, New York",5179,1087,4092,0.79,0.21
36001012700,"Census Tract 127, Albany County, New York",3391,2607,784,0.23,0.77
36001012800,"Census Tract 128, Albany County, New York",3797,2713,1084,0.29,0.71
36001012900,"Census Tract 129, Albany County, New York",3931,2749,1182,0.3,0.7
36001013000,"Census Tract 130, Albany County, New York",7028,5989,1039,0.15,0.85
36001013100,"Census Tract 131, Albany County, New York",2934,2102,832,0.28,0.72
36001013200,"Census Tract 132, Albany County, New York",3380,1938,1442,0.43,0.57
36001013300,"Census Tract 133, Albany County, New York",4397,2790,1607,0.37,0.63
36001013400,"Census Tract 134, Albany County, New York",2598,1860,738,0.28,0.72
36001013503,"Census Tract 135.03, Albany County, New York",5284,3537,1747,0.33,0.67
36001013505,"Census Tract 135.05, Albany County, New York",2804,2183,621,0.22,0.78
36001013507,"Census Tract 135.07, Albany County, New York",2716,1813,903,0.33,0.67
36001013509,"Census Tract 135.09, Albany County, New York",3692,2610,1082,0.29,0.71
36001013510,"Census Tract 135.10, Albany County, New York",3497,2498,999,0.29,0.71
36001013511,"Census Tract 135.11, Albany County, New York",3687,2450,1237,0.34,0.66
36001013512,"Census Tract 135.12, Albany County, New York",3858,3046,812,0.21,0.79
36001013602,"Census Tract 136.02, Albany County, New York",4554,2530,2024,0.44,0.56
36001013603,"Census Tract 136.03, Albany County, New York",3151,2322,829,0.26,0.74
36001013604,"Census Tract 136.04, Albany County, New York",7198,5301,1897,0.26,0.74
36001013703,"Census Tract 137.03, Albany County, New York",2101,1577,524,0.25,0.75
36001013706,"Census Tract 137.06, Albany County, New York",2087,1748,339,0.16,0.84
36001013707,"Census Tract 137.07, Albany County, New York",6066,4941,1125,0.19,0.81
36001013708,"Census Tract 137.08, Albany County, New York",3494,2868,626,0.18,0.82
36001013709,"Census Tract 137.09, Albany County, New York",3313,2589,724,0.22,0.78
36001013802,"Census Tract 138.02, Albany County, New York",4487,3562,925,0.21,0.79
36001013803,"Census Tract 138.03, Albany County, New York",3347,2542,805,0.24,0.76
36001013804,"Census Tract 138.04, Albany County, New York",3897,2917,980,0.25,0.75
36001013901,"Census Tract 139.01, Albany County, New York",2396,1828,568,0.24,0.76
36001013902,"Census Tract 139.02, Albany County, New York",5385,4006,1379,0.26,0.74
36001014001,"Census Tract 140.01, Albany County, New York",4200,2545,1655,0.39,0.61
36001014002,"Census Tract 140.02, Albany County, New York",4376,3154,1222,0.28,0.72
36001014100,"Census Tract 141, Albany County, New York",5628,4617,1011,0.18,0.82
36001014201,"Census Tract 142.01, Albany County, New York",5959,5026,933,0.16,0.84
36001014202,"Census Tract 142.02, Albany County, New York",6064,5266,798,0.13,0.87
36001014203,"Census Tract 142.03, Albany County, New York",6270,5442,828,0.13,0.87
36001014301,"Census Tract 143.01, Albany County, New York",3005,2396,609,0.2,0.8
36001014303,"Census Tract 143.03, Albany County, New York",4874,4014,860,0.18,0.82
36001014304,"Census Tract 143.04, Albany County, New York",3234,2668,566,0.18,0.82
36001014401,"Census Tract 144.01, Albany County, New York",3985,3494,491,0.12,0.88
36001014402,"Census Tract 144.02, Albany County, New York",3271,2603,668,0.2,0.8
36001014501,"Census Tract 145.01, Albany County, New York",2703,2428,275,0.1,0.9
36001014502,"Census Tract 145.02, Albany County, New York",3552,3194,358,0.1,0.9
36001014503,"Census Tract 145.03, Albany County, New York",2841,2536,305,0.11,0.89
36001014606,"Census Tract 146.06, Albany County, New York",3825,3134,691,0.18,0.82
36001014608,"Census Tract 146.08, Albany County, New York",4014,3103,911,0.23,0.77
36001014609,"Census Tract 146.09, Albany County, New York",4829,3519,1310,0.27,0.73
36001014611,"Census Tract 146.11, Albany County, New York",2260,1795,465,0.21,0.79
36001014612,"Census Tract 146.12, Albany County, New York",1675,1507,168,0.1,0.9
36001014613,"Census Tract 146.13, Albany County, New York",3132,2655,477,0.15,0.85
36001014614,"Census Tract 146.14, Albany County, New York",5767,3803,1964,0.34,0.66
36001014615,"Census Tract 146.15, Albany County, New York",2759,1508,1251,0.45,0.55
36001014616,"Census Tract 146.16, Albany County, New York",6214,4996,1218,0.2,0.8
36001014617,"Census Tract 146.17, Albany County, New York",2373,1998,375,0.16,0.84
36001014700,"Census Tract 147, Albany County, New York",2635,2379,256,0.1,0.9
36001014801,"Census Tract 148.01, Albany County, New York",2689,2454,235,0.09,0.91
36001014802,"Census Tract 148.02, Albany County, New York",1826,1685,141,0.08,0.92
36001014803,"Census Tract 148.03, Albany County, New York",3194,2968,226,0.07,0.93
36003940200,"Census Tract 9402, Allegany County, New York",7,2,5,0.71,0.29
36003950100,"Census Tract 9501, Allegany County, New York",2270,2126,144,0.06,0.94
36003950300,"Census Tract 9503, Allegany County, New York",4755,4341,414,0.09,0.91
36003950401,"Census Tract 9504.01, Allegany County, New York",1647,1560,87,0.05,0.95
36003950402,"Census Tract 9504.02, Allegany County, New York",1960,1850,110,0.06,0.94
36003950500,"Census Tract 9505, Allegany County, New York",3671,3351,320,0.09,0.91
36003950600,"Census Tract 9506, Allegany County, New York",3653,3349,304,0.08,0.92
36003950700,"Census Tract 9507, Allegany County, New York",3575,3339,236,0.07,0.93
36003950800,"Census Tract 9508, Allegany County, New York",6136,4721,1415,0.23,0.77
36003950900,"Census Tract 9509, Allegany County, New York",3649,3416,233,0.06,0.94
36003951000,"Census Tract 9510, Allegany County, New York",3116,2929,187,0.06,0.94
36003951100,"Census Tract 9511, Allegany County, New York",3772,3558,214,0.06,0.94
36003951201,"Census Tract 9512.01, Allegany County, New York",2301,2180,121,0.05,0.95
36003951202,"Census Tract 9512.02, Allegany County, New York",2475,2315,160,0.06,0.94
36003951301,"Census Tract 9513.01, Allegany County, New York",1350,1260,90,0.07,0.93
36003951302,"Census Tract 9513.02, Allegany County, New York",2119,2030,89,0.04,0.96
36005000100,"Census Tract 1, Bronx County, New York",3772,260,3512,0.93,0.07
36005000200,"Census Tract 2, Bronx County, New York",4779,152,4627,0.97,0.03
36005000400,"Census Tract 4, Bronx County, New York",6272,238,6034,0.96,0.04
36005001600,"Census Tract 16, Bronx County, New York",5795,121,5674,0.98,0.02
36005001901,"Census Tract 19.01, Bronx County, New York",2292,250,2042,0.89,0.11
36005001902,"Census Tract 19.02, Bronx County, New York",1613,165,1448,0.9,0.1
36005001903,"Census Tract 19.03, Bronx County, New York",2,0,2,1,0
36005001904,"Census Tract 19.04, Bronx County, New York",0,0,0,0,0
36005002001,"Census Tract 20.01, Bronx County, New York",5007,68,4939,0.99,0.01
36005002002,"Census Tract 20.02, Bronx County, New York",4584,66,4518,0.99,0.01
36005002300,"Census Tract 23, Bronx County, New York",4742,67,4675,0.99,0.01
36005002400,"Census Tract 24, Bronx County, New York",6,1,5,0.83,0.17
36005002500,"Census Tract 25, Bronx County, New York",5442,105,5337,0.98,0.02
36005002701,"Census Tract 27.01, Bronx County, New York",3080,35,3045,0.99,0.01
36005002702,"Census Tract 27.02, Bronx County, New York",4995,94,4901,0.98,0.02
36005002800,"Census Tract 28, Bronx County, New York",5853,89,5764,0.98,0.02
36005003100,"Census Tract 31, Bronx County, New York",2964,35,2929,0.99,0.01
36005003300,"Census Tract 33, Bronx County, New York",3689,55,3634,0.99,0.01
36005003500,"Census Tract 35, Bronx County, New York",3726,122,3604,0.97,0.03
36005003700,"Census Tract 37, Bronx County, New York",340,5,335,0.99,0.01
36005003800,"Census Tract 38, Bronx County, New York",1683,18,1665,0.99,0.01
36005003900,"Census Tract 39, Bronx County, New York",6345,249,6096,0.96,0.04
36005004001,"Census Tract 40.01, Bronx County, New York",1739,125,1614,0.93,0.07
36005004100,"Census Tract 41, Bronx County, New York",6146,94,6052,0.98,0.02
36005004200,"Census Tract 42, Bronx County, New York",7201,90,7111,0.99,0.01
36005004300,"Census Tract 43, Bronx County, New York",5883,130,5753,0.98,0.02
36005004400,"Census Tract 44, Bronx County, New York",4642,88,4554,0.98,0.02
36005004600,"Census Tract 46, Bronx County, New York",1976,53,1923,0.97,0.03
36005004800,"Census Tract 48, Bronx County, New York",4184,64,4120,0.98,0.02
36005005001,"Census Tract 50.01, Bronx County, New York",4960,81,4879,0.98,0.02
36005005002,"Census Tract 50.02, Bronx County, New York",6518,104,6414,0.98,0.02
36005005100,"Census Tract 51, Bronx County, New York",6459,163,6296,0.97,0.03
36005005200,"Census Tract 52, Bronx County, New York",2130,20,2110,0.99,0.01
36005005300,"Census Tract 53, Bronx County, New York",4371,38,4333,0.99,0.01
36005005400,"Census Tract 54, Bronx County, New York",6804,81,6723,0.99,0.01
36005005600,"Census Tract 56, Bronx County, New York",2863,30,2833,0.99,0.01
36005005902,"Census Tract 59.02, Bronx County, New York",2577,224,2353,0.91,0.09
36005006000,"Census Tract 60, Bronx County, New York",1262,16,1246,0.99,0.01
36005006100,"Census Tract 61, Bronx County, New York",3444,33,3411,0.99,0.01
36005006200,"Census Tract 62, Bronx County, New York",6769,102,6667,0.98,0.02
36005006301,"Census Tract 63.01, Bronx County, New York",6567,323,6244,0.95,0.05
36005006302,"Census Tract 63.02, Bronx County, New York",19,0,19,1,0
36005006400,"Census Tract 64, Bronx County, New York",4186,106,4080,0.97,0.03
36005006500,"Census Tract 65, Bronx County, New York",6251,225,6026,0.96,0.04
36005006700,"Census Tract 67, Bronx County, New York",6893,117,6776,0.98,0.02
36005006800,"Census Tract 68, Bronx County, New York",3419,60,3359,0.98,0.02
36005006900,"Census Tract 69, Bronx County, New York",6964,124,6840,0.98,0.02
36005007000,"Census Tract 70, Bronx County, New York",5021,105,4916,0.98,0.02
36005007100,"Census Tract 71, Bronx County, New York",2789,66,2723,0.98,0.02
36005007200,"Census Tract 72, Bronx County, New York",6291,309,5982,0.95,0.05
36005007300,"Census Tract 73, Bronx County, New York",4205,80,4125,0.98,0.02
36005007400,"Census Tract 74, Bronx County, New York",3536,57,3479,0.98,0.02
36005007500,"Census Tract 75, Bronx County, New York",6749,199,6550,0.97,0.03
36005007600,"Census Tract 76, Bronx County, New York",5682,170,5512,0.97,0.03
36005007700,"Census Tract 77, Bronx County, New York",1974,61,1913,0.97,0.03
36005007800,"Census Tract 78, Bronx County, New York",7037,230,6807,0.97,0.03
36005007900,"Census Tract 79, Bronx County, New York",6826,101,6725,0.99,0.01
36005008300,"Census Tract 83, Bronx County, New York",6122,72,6050,0.99,0.01
36005008400,"Census Tract 84, Bronx County, New York",2587,33,2554,0.99,0.01
36005008500,"Census Tract 85, Bronx County, New York",5894,141,5753,0.98,0.02
36005008600,"Census Tract 86, Bronx County, New York",4145,35,4110,0.99,0.01
36005008700,"Census Tract 87, Bronx County, New York",5976,84,5892,0.99,0.01
36005008900,"Census Tract 89, Bronx County, New York",3118,88,3030,0.97,0.03
36005009000,"Census Tract 90, Bronx County, New York",3911,60,3851,0.98,0.02
36005009200,"Census Tract 92, Bronx County, New York",6271,385,5886,0.94,0.06
36005009301,"Census Tract 93.01, Bronx County, New York",5551,85,5466,0.98,0.02
36005009302,"Census Tract 93.02, Bronx County, New York",512,32,480,0.94,0.06
36005009600,"Census Tract 96, Bronx County, New York",2946,191,2755,0.94,0.06
36005009800,"Census Tract 98, Bronx County, New York",5903,171,5732,0.97,0.03
36005011000,"Census Tract 110, Bronx County, New York",0,0,0,0,0
36005011502,"Census Tract 115.02, Bronx County, New York",4396,44,4352,0.99,0.01
36005011701,"Census Tract 117.01, Bronx County, New York",1554,15,1539,0.99,0.01
36005011702,"Census Tract 117.02, Bronx County, New York",0,0,0,0,0
36005011800,"Census Tract 118, Bronx County, New York",5324,3338,1986,0.37,0.63
36005011900,"Census Tract 119, Bronx County, New York",5703,125,5578,0.98,0.02
36005012101,"Census Tract 121.01, Bronx County, New York",3319,53,3266,0.98,0.02
36005012102,"Census Tract 121.02, Bronx County, New York",1616,20,1596,0.99,0.01
36005012300,"Census Tract 123, Bronx County, New York",4766,61,4705,0.99,0.01
36005012500,"Census Tract 125, Bronx County, New York",4139,75,4064,0.98,0.02
36005012701,"Census Tract 127.01, Bronx County, New York",2184,34,2150,0.98,0.02
36005012901,"Census Tract 129.01, Bronx County, New York",4923,86,4837,0.98,0.02
36005013000,"Census Tract 130, Bronx County, New York",1198,349,849,0.71,0.29
36005013100,"Census Tract 131, Bronx County, New York",5390,105,5285,0.98,0.02
36005013200,"Census Tract 132, Bronx County, New York",6652,1573,5079,0.76,0.24
36005013300,"Census Tract 133, Bronx County, New York",6064,69,5995,0.99,0.01
36005013500,"Census Tract 135, Bronx County, New York",4001,50,3951,0.99,0.01
36005013800,"Census Tract 138, Bronx County, New York",3060,1653,1407,0.46,0.54
36005014100,"Census Tract 141, Bronx County, New York",7344,149,7195,0.98,0.02
36005014300,"Census Tract 143, Bronx County, New York",1898,63,1835,0.97,0.03
36005014400,"Census Tract 144, Bronx County, New York",6046,221,5825,0.96,0.04
36005014500,"Census Tract 145, Bronx County, New York",7055,116,6939,0.98,0.02
36005014701,"Census Tract 147.01, Bronx County, New York",6361,41,6320,0.99,0.01
36005014702,"Census Tract 147.02, Bronx County, New York",5081,36,5045,0.99,0.01
36005014900,"Census Tract 149, Bronx County, New York",4723,104,4619,0.98,0.02
36005015100,"Census Tract 151, Bronx County, New York",5957,123,5834,0.98,0.02
36005015200,"Census Tract 152, Bronx County, New York",2593,664,1929,0.74,0.26
36005015300,"Census Tract 153, Bronx County, New York",4258,72,4186,0.98,0.02
36005015500,"Census Tract 155, Bronx County, New York",2891,33,2858,0.99,0.01
36005015700,"Census Tract 157, Bronx County, New York",5542,78,5464,0.99,0.01
36005015800,"Census Tract 158, Bronx County, New York",1442,513,929,0.64,0.36
36005015900,"Census Tract 159, Bronx County, New York",2481,23,2458,0.99,0.01
36005016000,"Census Tract 160, Bronx County, New York",4003,1947,2056,0.51,0.49
36005016100,"Census Tract 161, Bronx County, New York",5243,116,5127,0.98,0.02
36005016200,"Census Tract 162, Bronx County, New York",1908,708,1200,0.63,0.37
36005016300,"Census Tract 163, Bronx County, New York",34,5,29,0.85,0.15
36005016400,"Census Tract 164, Bronx County, New York",1221,523,698,0.57,0.43
36005016500,"Census Tract 165, Bronx County, New York",1097,17,1080,0.98,0.02
36005016600,"Census Tract 166, Bronx County, New York",2625,556,2069,0.79,0.21
36005016700,"Census Tract 167, Bronx County, New York",3373,65,3308,0.98,0.02
36005016900,"Census Tract 169, Bronx County, New York",1586,20,1566,0.99,0.01
36005017100,"Census Tract 171, Bronx County, New York",10,0,10,1,0
36005017300,"Census Tract 173, Bronx County, New York",6395,98,6297,0.98,0.02
36005017500,"Census Tract 175, Bronx County, New York",6988,141,6847,0.98,0.02
36005017701,"Census Tract 177.01, Bronx County, New York",4754,224,4530,0.95,0.05
36005017702,"Census Tract 177.02, Bronx County, New York",4979,67,4912,0.99,0.01
36005017901,"Census Tract 179.01, Bronx County, New York",5124,66,5058,0.99,0.01
36005017902,"Census Tract 179.02, Bronx County, New York",3447,51,3396,0.99,0.01
36005018101,"Census Tract 181.01, Bronx County, New York",3299,72,3227,0.98,0.02
36005018102,"Census Tract 181.02, Bronx County, New York",5510,130,5380,0.98,0.02
36005018301,"Census Tract 183.01, Bronx County, New York",4423,262,4161,0.94,0.06
36005018302,"Census Tract 183.02, Bronx County, New York",3686,45,3641,0.99,0.01
36005018400,"Census Tract 184, Bronx County, New York",4329,1804,2525,0.58,0.42
36005018501,"Census Tract 185.01, Bronx County, New York",3076,70,3006,0.98,0.02
36005018502,"Census Tract 185.02, Bronx County, New York",6442,144,6298,0.98,0.02
36005018900,"Census Tract 189, Bronx County, New York",8360,222,8138,0.97,0.03
36005019300,"Census Tract 193, Bronx County, New York",6020,97,5923,0.98,0.02
36005019400,"Census Tract 194, Bronx County, New York",2022,304,1718,0.85,0.15
36005019500,"Census Tract 195, Bronx County, New York",7509,201,7308,0.97,0.03
36005019700,"Census Tract 197, Bronx County, New York",7213,59,7154,0.99,0.01
36005019900,"Census Tract 199, Bronx County, New York",7909,134,7775,0.98,0.02
36005020000,"Census Tract 200, Bronx County, New York",5235,278,4957,0.95,0.05
36005020100,"Census Tract 201, Bronx County, New York",4345,99,4246,0.98,0.02
36005020200,"Census Tract 202, Bronx County, New York",2789,240,2549,0.91,0.09
36005020400,"Census Tract 204, Bronx County, New York",3129,196,2933,0.94,0.06
36005020501,"Census Tract 205.01, Bronx County, New York",7859,99,7760,0.99,0.01
36005020502,"Census Tract 205.02, Bronx County, New York",2462,42,2420,0.98,0.02
36005020601,"Census Tract 206.01, Bronx County, New York",3277,243,3034,0.93,0.07
36005020900,"Census Tract 209, Bronx County, New York",4823,108,4715,0.98,0.02
36005021001,"Census Tract 210.01, Bronx County, New York",8946,232,8714,0.97,0.03
36005021002,"Census Tract 210.02, Bronx County, New York",7855,188,7667,0.98,0.02
36005021100,"Census Tract 211, Bronx County, New York",5822,79,5743,0.99,0.01
36005021200,"Census Tract 212, Bronx County, New York",6596,143,6453,0.98,0.02
36005021301,"Census Tract 213.01, Bronx County, New York",1264,18,1246,0.99,0.01
36005021302,"Census Tract 213.02, Bronx County, New York",5830,44,5786,0.99,0.01
36005021501,"Census Tract 215.01, Bronx County, New York",4078,49,4029,0.99,0.01
36005021502,"Census Tract 215.02, Bronx County, New York",6360,104,6256,0.98,0.02
36005021601,"Census Tract 216.01, Bronx County, New York",4701,304,4397,0.94,0.06
36005021602,"Census Tract 216.02, Bronx County, New York",6237,168,6069,0.97,0.03
36005021700,"Census Tract 217, Bronx County, New York",5006,122,4884,0.98,0.02
36005021800,"Census Tract 218, Bronx County, New York",6610,206,6404,0.97,0.03
36005021900,"Census Tract 219, Bronx County, New York",1176,32,1144,0.97,0.03
36005022000,"Census Tract 220, Bronx County, New York",2511,82,2429,0.97,0.03
36005022101,"Census Tract 221.01, Bronx County, New York",4001,34,3967,0.99,0.01
36005022102,"Census Tract 221.02, Bronx County, New York",5457,53,5404,0.99,0.01
36005022200,"Census Tract 222, Bronx County, New York",3968,176,3792,0.96,0.04
36005022300,"Census Tract 223, Bronx County, New York",5063,74,4989,0.99,0.01
36005022401,"Census Tract 224.01, Bronx County, New York",2787,333,2454,0.88,0.12
36005022403,"Census Tract 224.03, Bronx County, New York",3275,414,2861,0.87,0.13
36005022404,"Census Tract 224.04, Bronx County, New York",4489,742,3747,0.83,0.17
36005022500,"Census Tract 225, Bronx County, New York",8141,126,8015,0.98,0.02
36005022701,"Census Tract 227.01, Bronx County, New York",5669,65,5604,0.99,0.01
36005022702,"Census Tract 227.02, Bronx County, New York",1634,35,1599,0.98,0.02
36005022703,"Census Tract 227.03, Bronx County, New York",1699,39,1660,0.98,0.02
36005022800,"Census Tract 228, Bronx County, New York",6336,1188,5148,0.81,0.19
36005022901,"Census Tract 229.01, Bronx County, New York",5766,125,5641,0.98,0.02
36005022902,"Census Tract 229.02, Bronx County, New York",3401,48,3353,0.99,0.01
36005023000,"Census Tract 230, Bronx County, New York",3001,549,2452,0.82,0.18
36005023100,"Census Tract 231, Bronx County, New York",1464,11,1453,0.99,0.01
36005023200,"Census Tract 232, Bronx County, New York",3000,695,2305,0.77,0.23
36005023301,"Census Tract 233.01, Bronx County, New York",4577,78,4499,0.98,0.02
36005023302,"Census Tract 233.02, Bronx County, New York",3574,43,3531,0.99,0.01
36005023501,"Census Tract 235.01, Bronx County, New York",3570,33,3537,0.99,0.01
36005023502,"Census Tract 235.02, Bronx County, New York",4417,47,4370,0.99,0.01
36005023600,"Census Tract 236, Bronx County, New York",2204,497,1707,0.77,0.23
36005023702,"Census Tract 237.02, Bronx County, New York",1179,27,1152,0.98,0.02
36005023703,"Census Tract 237.03, Bronx County, New York",5086,141,4945,0.97,0.03
36005023704,"Census Tract 237.04, Bronx County, New York",3970,51,3919,0.99,0.01
36005023800,"Census Tract 238, Bronx County, New York",2750,655,2095,0.76,0.24
36005023900,"Census Tract 239, Bronx County, New York",8213,86,8127,0.99,0.01
36005024000,"Census Tract 240, Bronx County, New York",4583,392,4191,0.91,0.09
36005024100,"Census Tract 241, Bronx County, New York",6331,100,6231,0.98,0.02
36005024300,"Census Tract 243, Bronx County, New York",5577,92,5485,0.98,0.02
36005024400,"Census Tract 244, Bronx County, New York",2407,879,1528,0.63,0.37
36005024501,"Census Tract 245.01, Bronx County, New York",5059,76,4983,0.98,0.02
36005024502,"Census Tract 245.02, Bronx County, New York",3797,26,3771,0.99,0.01
36005024600,"Census Tract 246, Bronx County, New York",2297,863,1434,0.62,0.38
36005024700,"Census Tract 247, Bronx County, New York",1921,53,1868,0.97,0.03
36005024800,"Census Tract 248, Bronx County, New York",3620,1508,2112,0.58,0.42
36005024900,"Census Tract 249, Bronx County, New York",4,0,4,1,0
36005025000,"Census Tract 250, Bronx County, New York",2672,1397,1275,0.48,0.52
36005025100,"Census Tract 251, Bronx County, New York",6924,99,6825,0.99,0.01
36005025200,"Census Tract 252, Bronx County, New York",2682,1130,1552,0.58,0.42
36005025300,"Census Tract 253, Bronx County, New York",6234,100,6134,0.98,0.02
36005025400,"Census Tract 254, Bronx County, New York",2163,1018,1145,0.53,0.47
36005025500,"Census Tract 255, Bronx County, New York",8092,544,7548,0.93,0.07
36005025600,"Census Tract 256, Bronx County, New York",1908,466,1442,0.76,0.24
36005025700,"Census Tract 257, Bronx County, New York",1809,47,1762,0.97,0.03
36005026100,"Census Tract 261, Bronx County, New York",2060,140,1920,0.93,0.07
36005026300,"Census Tract 263, Bronx County, New York",6788,283,6505,0.96,0.04
36005026400,"Census Tract 264, Bronx County, New York",5693,1965,3728,0.65,0.35
36005026500,"Census Tract 265, Bronx County, New York",7166,212,6954,0.97,0.03
36005026601,"Census Tract 266.01, Bronx County, New York",3328,1096,2232,0.67,0.33
36005026602,"Census Tract 266.02, Bronx County, New York",6409,1858,4551,0.71,0.29
36005026701,"Census Tract 267.01, Bronx County, New York",3983,161,3822,0.96,0.04
36005026702,"Census Tract 267.02, Bronx County, New York",7022,287,6735,0.96,0.04
36005026900,"Census Tract 269, Bronx County, New York",4126,156,3970,0.96,0.04
36005027300,"Census Tract 273, Bronx County, New York",7939,523,7416,0.93,0.07
36005027401,"Census Tract 274.01, Bronx County, New York",5136,3067,2069,0.4,0.6
36005027402,"Census Tract 274.02, Bronx County, New York",3553,2390,1163,0.33,0.67
36005027600,"Census Tract 276, Bronx County, New York",23,5,18,0.78,0.22
36005027700,"Census Tract 277, Bronx County, New York",4968,399,4569,0.92,0.08
36005027900,"Census Tract 279, Bronx County, New York",8145,1280,6865,0.84,0.16
36005028100,"Census Tract 281, Bronx County, New York",3720,1091,2629,0.71,0.29
36005028300,"Census Tract 283, Bronx County, New York",2084,141,1943,0.93,0.07
36005028400,"Census Tract 284, Bronx County, New York",297,56,241,0.81,0.19
36005028500,"Census Tract 285, Bronx County, New York",3440,1384,2056,0.6,0.4
36005028600,"Census Tract 286, Bronx County, New York",1395,619,776,0.56,0.44
36005028700,"Census Tract 287, Bronx County, New York",3953,670,3283,0.83,0.17
36005028800,"Census Tract 288, Bronx County, New York",3055,1833,1222,0.4,0.6
36005028900,"Census Tract 289, Bronx County, New York",4736,819,3917,0.83,0.17
36005029301,"Census Tract 293.01, Bronx County, New York",1954,1265,689,0.35,0.65
36005029302,"Census Tract 293.02, Bronx County, New York",5248,3034,2214,0.42,0.58
36005029500,"Census Tract 295, Bronx County, New York",4615,2238,2377,0.52,0.48
36005029600,"Census Tract 296, Bronx County, New York",2878,936,1942,0.67,0.33
36005029700,"Census Tract 297, Bronx County, New York",4005,2337,1668,0.42,0.58
36005030000,"Census Tract 300, Bronx County, New York",6591,2062,4529,0.69,0.31
36005030100,"Census Tract 301, Bronx County, New York",1627,823,804,0.49,0.51
36005030201,"Census Tract 302.01, Bronx County, New York",4048,212,3836,0.95,0.05
36005030202,"Census Tract 302.02, Bronx County, New York",6063,208,5855,0.97,0.03
36005030701,"Census Tract 307.01, Bronx County, New York",5799,3998,1801,0.31,0.69
36005030900,"Census Tract 309, Bronx County, New York",3947,2628,1319,0.33,0.67
36005031000,"Census Tract 310, Bronx County, New York",4372,1212,3160,0.72,0.28
36005031200,"Census Tract 312, Bronx County, New York",1555,483,1072,0.69,0.31
36005031400,"Census Tract 314, Bronx County, New York",2071,625,1446,0.7,0.3
36005031600,"Census Tract 316, Bronx County, New York",2071,672,1399,0.68,0.32
36005031800,"Census Tract 318, Bronx County, New York",1961,587,1374,0.7,0.3
36005031900,"Census Tract 319, Bronx County, New York",454,206,248,0.55,0.45
36005032300,"Census Tract 323, Bronx County, New York",5001,2737,2264,0.45,0.55
36005032400,"Census Tract 324, Bronx County, New York",3113,439,2674,0.86,0.14
36005032600,"Census Tract 326, Bronx County, New York",3494,1099,2395,0.69,0.31
36005032800,"Census Tract 328, Bronx County, New York",4133,727,3406,0.82,0.18
36005033000,"Census Tract 330, Bronx County, New York",5837,1671,4166,0.71,0.29
36005033201,"Census Tract 332.01, Bronx County, New York",4103,628,3475,0.85,0.15
36005033202,"Census Tract 332.02, Bronx County, New York",4204,460,3744,0.89,0.11
36005033400,"Census Tract 334, Bronx County, New York",69,6,63,0.91,0.09
36005033500,"Census Tract 335, Bronx County, New York",2440,1578,862,0.35,0.65
36005033601,"Census Tract 336.01, Bronx County, New York",4306,116,4190,0.97,0.03
36005033602,"Census Tract 336.02, Bronx County, New York",1555,92,1463,0.94,0.06
36005033700,"Census Tract 337, Bronx County, New York",3838,2094,1744,0.45,0.55
36005033801,"Census Tract 338.01, Bronx County, New York",2337,168,2169,0.93,0.07
36005033802,"Census Tract 338.02, Bronx County, New York",1737,78,1659,0.96,0.04
36005034000,"Census Tract 340, Bronx County, New York",4858,422,4436,0.91,0.09
36005034200,"Census Tract 342, Bronx County, New York",1732,103,1629,0.94,0.06
36005034300,"Census Tract 343, Bronx County, New York",1706,605,1101,0.65,0.35
36005034400,"Census Tract 344, Bronx County, New York",1930,96,1834,0.95,0.05
36005034500,"Census Tract 345, Bronx County, New York",3754,1443,2311,0.62,0.38
36005034800,"Census Tract 348, Bronx County, New York",6640,274,6366,0.96,0.04
36005035000,"Census Tract 350, Bronx County, New York",2284,109,2175,0.95,0.05
36005035100,"Census Tract 351, Bronx County, New York",3539,1680,1859,0.53,0.47
36005035600,"Census Tract 356, Bronx County, New York",2261,79,2182,0.97,0.03
36005035800,"Census Tract 358, Bronx County, New York",7542,98,7444,0.99,0.01
36005035900,"Census Tract 359, Bronx County, New York",3731,59,3672,0.98,0.02
36005036000,"Census Tract 360, Bronx County, New York",3024,341,2683,0.89,0.11
36005036100,"Census Tract 361, Bronx County, New York",5569,42,5527,0.99,0.01
36005036300,"Census Tract 363, Bronx County, New York",7074,91,6983,0.99,0.01
36005036400,"Census Tract 364, Bronx County, New York",2603,33,2570,0.99,0.01
36005036501,"Census Tract 365.01, Bronx County, New York",3897,26,3871,0.99,0.01
36005036502,"Census Tract 365.02, Bronx County, New York",2449,52,2397,0.98,0.02
36005036700,"Census Tract 367, Bronx County, New York",2672,72,2600,0.97,0.03
36005036800,"Census Tract 368, Bronx County, New York",2165,29,2136,0.99,0.01
36005036901,"Census Tract 369.01, Bronx County, New York",1910,27,1883,0.99,0.01
36005036902,"Census Tract 369.02, Bronx County, New York",2324,52,2272,0.98,0.02
36005037000,"Census Tract 370, Bronx County, New York",2536,50,2486,0.98,0.02
36005037100,"Census Tract 371, Bronx County, New York",4504,68,4436,0.98,0.02
36005037200,"Census Tract 372, Bronx County, New York",2289,67,2222,0.97,0.03
36005037300,"Census Tract 373, Bronx County, New York",6117,109,6008,0.98,0.02
36005037400,"Census Tract 374, Bronx County, New York",3890,92,3798,0.98,0.02
36005037504,"Census Tract 375.04, Bronx County, New York",4023,112,3911,0.97,0.03
36005037600,"Census Tract 376, Bronx County, New York",2274,124,2150,0.95,0.05
36005037800,"Census Tract 378, Bronx County, New York",3569,120,3449,0.97,0.03
36005037900,"Census Tract 379, Bronx County, New York",6878,122,6756,0.98,0.02
36005038000,"Census Tract 380, Bronx County, New York",4938,110,4828,0.98,0.02
36005038100,"Census Tract 381, Bronx County, New York",6853,112,6741,0.98,0.02
36005038200,"Census Tract 382, Bronx County, New York",2852,47,2805,0.98,0.02
36005038301,"Census Tract 383.01, Bronx County, New York",4635,82,4553,0.98,0.02
36005038303,"Census Tract 383.03, Bronx County, New York",3468,36,3432,0.99,0.01
36005038304,"Census Tract 383.04, Bronx County, New York",2508,61,2447,0.98,0.02
36005038500,"Census Tract 385, Bronx County, New York",5362,124,5238,0.98,0.02
36005038600,"Census Tract 386, Bronx County, New York",7949,77,7872,0.99,0.01
36005038700,"Census Tract 387, Bronx County, New York",3401,355,3046,0.9,0.1
36005038800,"Census Tract 388, Bronx County, New York",2941,48,2893,0.98,0.02
36005038900,"Census Tract 389, Bronx County, New York",4819,913,3906,0.81,0.19
36005039000,"Census Tract 390, Bronx County, New York",3323,54,3269,0.98,0.02
36005039100,"Census Tract 391, Bronx County, New York",7210,560,6650,0.92,0.08
36005039200,"Census Tract 392, Bronx County, New York",1809,37,1772,0.98,0.02
36005039300,"Census Tract 393, Bronx County, New York",8033,261,7772,0.97,0.03
36005039400,"Census Tract 394, Bronx County, New York",4647,151,4496,0.97,0.03
36005039500,"Census Tract 395, Bronx County, New York",4254,81,4173,0.98,0.02
36005039600,"Census Tract 396, Bronx County, New York",4485,58,4427,0.99,0.01
36005039700,"Census Tract 397, Bronx County, New York",4492,2458,2034,0.45,0.55
36005039800,"Census Tract 398, Bronx County, New York",3347,55,3292,0.98,0.02
36005039901,"Census Tract 399.01, Bronx County, New York",5254,160,5094,0.97,0.03
36005039902,"Census Tract 399.02, Bronx County, New York",5548,100,5448,0.98,0.02
36005040100,"Census Tract 401, Bronx County, New York",5009,158,4851,0.97,0.03
36005040302,"Census Tract 403.02, Bronx County, New York",4197,75,4122,0.98,0.02
36005040303,"Census Tract 403.03, Bronx County, New York",4843,132,4711,0.97,0.03
36005040304,"Census Tract 403.04, Bronx County, New York",4125,108,4017,0.97,0.03
36005040400,"Census Tract 404, Bronx County, New York",3530,39,3491,0.99,0.01
36005040501,"Census Tract 405.01, Bronx County, New York",4385,111,4274,0.97,0.03
36005040502,"Census Tract 405.02, Bronx County, New York",7320,175,7145,0.98,0.02
36005040600,"Census Tract 406, Bronx County, New York",3792,61,3731,0.98,0.02
36005040701,"Census Tract 407.01, Bronx County, New York",3235,204,3031,0.94,0.06
36005040702,"Census Tract 407.02, Bronx County, New York",6968,514,6454,0.93,0.07
36005040800,"Census Tract 408, Bronx County, New York",4475,110,4365,0.98,0.02
36005040900,"Census Tract 409, Bronx County, New York",3580,420,3160,0.88,0.12
36005041100,"Census Tract 411, Bronx County, New York",3215,234,2981,0.93,0.07
36005041300,"Census Tract 413, Bronx County, New York",7781,857,6924,0.89,0.11
36005041400,"Census Tract 414, Bronx County, New York",5342,200,5142,0.96,0.04
36005041500,"Census Tract 415, Bronx County, New York",5872,631,5241,0.89,0.11
36005041800,"Census Tract 418, Bronx County, New York",3752,165,3587,0.96,0.04
36005041900,"Census Tract 419, Bronx County, New York",7205,566,6639,0.92,0.08
36005042000,"Census Tract 420, Bronx County, New York",3905,98,3807,0.97,0.03
36005042100,"Census Tract 421, Bronx County, New York",6135,468,5667,0.92,0.08
36005042200,"Census Tract 422, Bronx County, New York",3211,83,3128,0.97,0.03
36005042300,"Census Tract 423, Bronx County, New York",4179,431,3748,0.9,0.1
36005042400,"Census Tract 424, Bronx County, New York",2553,78,2475,0.97,0.03
36005042500,"Census Tract 425, Bronx County, New York",7667,691,6976,0.91,0.09
36005042600,"Census Tract 426, Bronx County, New York",6982,91,6891,0.99,0.01
36005042800,"Census Tract 428, Bronx County, New York",2230,37,2193,0.98,0.02
36005042901,"Census Tract 429.01, Bronx County, New York",3711,244,3467,0.93,0.07
36005042902,"Census Tract 429.02, Bronx County, New York",4334,257,4077,0.94,0.06
36005043000,"Census Tract 430, Bronx County, New York",2952,69,2883,0.98,0.02
36005043101,"Census Tract 431.01, Bronx County, New York",5185,236,4949,0.95,0.05
36005043102,"Census Tract 431.02, Bronx County, New York",5050,200,4850,0.96,0.04
36005043400,"Census Tract 434, Bronx County, New York",3649,179,3470,0.95,0.05
36005043501,"Census Tract 435.01, Bronx County, New York",1192,13,1179,0.99,0.01
36005043502,"Census Tract 435.02, Bronx County, New York",2,0,2,1,0
36005043503,"Census Tract 435.03, Bronx County, New York",122,29,93,0.76,0.24
36005043600,"Census Tract 436, Bronx County, New York",2061,56,2005,0.97,0.03
36005044200,"Census Tract 442, Bronx County, New York",3877,51,3826,0.99,0.01
36005044400,"Census Tract 444, Bronx County, New York",3984,100,3884,0.97,0.03
36005044800,"Census Tract 448, Bronx County, New York",2007,30,1977,0.99,0.01
36005044901,"Census Tract 449.01, Bronx County, New York",1946,1348,598,0.31,0.69
36005044902,"Census Tract 449.02, Bronx County, New York",2229,1499,730,0.33,0.67
36005045101,"Census Tract 451.01, Bronx County, New York",1817,1229,588,0.32,0.68
36005045102,"Census Tract 451.02, Bronx County, New York",2142,1450,692,0.32,0.68
36005045600,"Census Tract 456, Bronx County, New York",3056,435,2621,0.86,0.14
36005045800,"Census Tract 458, Bronx County, New York",5662,44,5618,0.99,0.01
36005046000,"Census Tract 460, Bronx County, New York",2890,42,2848,0.99,0.01
36005046203,"Census Tract 462.03, Bronx County, New York",6599,415,6184,0.94,0.06
36005046204,"Census Tract 462.04, Bronx County, New York",5552,326,5226,0.94,0.06
36005046205,"Census Tract 462.05, Bronx County, New York",4445,235,4210,0.95,0.05
36005046206,"Census Tract 462.06, Bronx County, New York",4434,194,4240,0.96,0.04
36005046207,"Census Tract 462.07, Bronx County, New York",6228,340,5888,0.95,0.05
36005046208,"Census Tract 462.08, Bronx County, New York",5155,122,5033,0.98,0.02
36005046209,"Census Tract 462.09, Bronx County, New York",3707,19,3688,0.99,0.01
36005048401,"Census Tract 484.01, Bronx County, New York",3888,65,3823,0.98,0.02
36005048402,"Census Tract 484.02, Bronx County, New York",41,0,41,1,0
36005050400,"Census Tract 504, Bronx County, New York",5,0,5,1,0
36005051601,"Census Tract 516.01, Bronx County, New York",4445,2735,1710,0.38,0.62
36005051602,"Census Tract 516.02, Bronx County, New York",0,0,0,0,0
36007000100,"Census Tract 1, Broome County, New York",3180,1667,1513,0.48,0.52
36007000200,"Census Tract 2, Broome County, New York",3247,1913,1334,0.41,0.59
36007000300,"Census Tract 3, Broome County, New York",2789,1748,1041,0.37,0.63
36007000400,"Census Tract 4, Broome County, New York",2244,1513,731,0.33,0.67
36007000500,"Census Tract 5, Broome County, New York",1961,890,1071,0.55,0.45
36007000600,"Census Tract 6, Broome County, New York",2252,1339,913,0.41,0.59
36007000700,"Census Tract 7, Broome County, New York",3501,2755,746,0.21,0.79
36007000900,"Census Tract 9, Broome County, New York",1717,1095,622,0.36,0.64
36007001100,"Census Tract 11, Broome County, New York",2147,1160,987,0.46,0.54
36007001200,"Census Tract 12, Broome County, New York",1797,1221,576,0.32,0.68
36007001300,"Census Tract 13, Broome County, New York",2932,1650,1282,0.44,0.56
36007001401,"Census Tract 14.01, Broome County, New York",2338,1296,1042,0.45,0.55
36007001402,"Census Tract 14.02, Broome County, New York",2875,1938,937,0.33,0.67
36007001500,"Census Tract 15, Broome County, New York",4530,3559,971,0.21,0.79
36007001600,"Census Tract 16, Broome County, New York",2277,1837,440,0.19,0.81
36007001700,"Census Tract 17, Broome County, New York",4090,3009,1081,0.26,0.74
36007001800,"Census Tract 18, Broome County, New York",4092,2486,1606,0.39,0.61
36007010200,"Census Tract 102, Broome County, New York",5168,4776,392,0.08,0.92
36007011901,"Census Tract 119.01, Broome County, New York",2809,2609,200,0.07,0.93
36007011902,"Census Tract 119.02, Broome County, New York",2509,2267,242,0.1,0.9
36007011903,"Census Tract 119.03, Broome County, New York",2691,2486,205,0.08,0.92
36007012000,"Census Tract 120, Broome County, New York",1581,1465,116,0.07,0.93
36007012101,"Census Tract 121.01, Broome County, New York",3732,3461,271,0.07,0.93
36007012102,"Census Tract 121.02, Broome County, New York",3953,3582,371,0.09,0.91
36007012103,"Census Tract 121.03, Broome County, New York",3274,2941,333,0.1,0.9
36007012201,"Census Tract 122.01, Broome County, New York",2492,2288,204,0.08,0.92
36007012202,"Census Tract 122.02, Broome County, New York",3937,3608,329,0.08,0.92
36007012300,"Census Tract 123, Broome County, New York",4868,4426,442,0.09,0.91
36007012400,"Census Tract 124, Broome County, New York",2239,2039,200,0.09,0.91
36007012501,"Census Tract 125.01, Broome County, New York",2543,2300,243,0.1,0.9
36007012502,"Census Tract 125.02, Broome County, New York",3261,3009,252,0.08,0.92
36007012600,"Census Tract 126, Broome County, New York",5481,4854,627,0.11,0.89
36007012701,"Census Tract 127.01, Broome County, New York",5008,4458,550,0.11,0.89
36007012702,"Census Tract 127.02, Broome County, New York",4617,4151,466,0.1,0.9
36007012800,"Census Tract 128, Broome County, New York",5100,4183,917,0.18,0.82
36007012900,"Census Tract 129, Broome County, New York",1272,1165,107,0.08,0.92
36007013000,"Census Tract 130, Broome County, New York",4218,3636,582,0.14,0.86
36007013100,"Census Tract 131, Broome County, New York",2794,2118,676,0.24,0.76
36007013201,"Census Tract 132.01, Broome County, New York",2286,1971,315,0.14,0.86
36007013202,"Census Tract 132.02, Broome County, New York",3186,2788,398,0.12,0.88
36007013301,"Census Tract 133.01, Broome County, New York",4851,4188,663,0.14,0.86
36007013303,"Census Tract 133.03, Broome County, New York",2570,2254,316,0.12,0.88
36007013304,"Census Tract 133.04, Broome County, New York",5951,5201,750,0.13,0.87
36007013400,"Census Tract 134, Broome County, New York",4499,3611,888,0.2,0.8
36007013500,"Census Tract 135, Broome County, New York",1988,1160,828,0.42,0.58
36007013600,"Census Tract 136, Broome County, New York",3928,2953,975,0.25,0.75
36007013700,"Census Tract 137, Broome County, New York",3252,2461,791,0.24,0.76
36007013800,"Census Tract 138, Broome County, New York",3463,2725,738,0.21,0.79
36007013900,"Census Tract 139, Broome County, New York",1992,1167,825,0.41,0.59
36007014000,"Census Tract 140, Broome County, New York",3181,1807,1374,0.43,0.57
36007014100,"Census Tract 141, Broome County, New York",3089,2485,604,0.2,0.8
36007014200,"Census Tract 142, Broome County, New York",3618,2968,650,0.18,0.82
36007014301,"Census Tract 143.01, Broome County, New York",5382,3525,1857,0.35,0.65
36007014302,"Census Tract 143.02, Broome County, New York",10881,6686,4195,0.39,0.61
36007014400,"Census Tract 144, Broome County, New York",4744,4015,729,0.15,0.85
36007014500,"Census Tract 145, Broome County, New York",3155,2800,355,0.11,0.89
36007014600,"Census Tract 146, Broome County, New York",5151,4510,641,0.12,0.88
36009940000,"Census Tract 9400, Cattaraugus County, New York",498,239,259,0.52,0.48
36009940200,"Census Tract 9402, Cattaraugus County, New York",13,8,5,0.38,0.62
36009940301,"Census Tract 9403.01, Cattaraugus County, New York",3136,1580,1556,0.5,0.5
36009940302,"Census Tract 9403.02, Cattaraugus County, New York",3528,2250,1278,0.36,0.64
36009960100,"Census Tract 9601, Cattaraugus County, New York",3415,3288,127,0.04,0.96
36009960200,"Census Tract 9602, Cattaraugus County, New York",4427,4124,303,0.07,0.93
36009960300,"Census Tract 9603, Cattaraugus County, New York",4344,4084,260,0.06,0.94
36009960400,"Census Tract 9604, Cattaraugus County, New York",4067,3634,433,0.11,0.89
36009960500,"Census Tract 9605, Cattaraugus County, New York",4859,4577,282,0.06,0.94
36009960600,"Census Tract 9606, Cattaraugus County, New York",3372,3127,245,0.07,0.93
36009960703,"Census Tract 9607.03, Cattaraugus County, New York",1751,1549,202,0.12,0.88
36009960704,"Census Tract 9607.04, Cattaraugus County, New York",1086,986,100,0.09,0.91
36009960800,"Census Tract 9608, Cattaraugus County, New York",4120,3820,300,0.07,0.93
36009961000,"Census Tract 9610, Cattaraugus County, New York",4395,4089,306,0.07,0.93
36009961100,"Census Tract 9611, Cattaraugus County, New York",3987,3655,332,0.08,0.92
36009961200,"Census Tract 9612, Cattaraugus County, New York",3426,3198,228,0.07,0.93
36009961301,"Census Tract 9613.01, Cattaraugus County, New York",2442,2278,164,0.07,0.93
36009961302,"Census Tract 9613.02, Cattaraugus County, New York",2465,2123,342,0.14,0.86
36009961400,"Census Tract 9614, Cattaraugus County, New York",5002,4656,346,0.07,0.93
36009961500,"Census Tract 9615, Cattaraugus County, New York",2165,1906,259,0.12,0.88
36009961600,"Census Tract 9616, Cattaraugus County, New York",3752,3154,598,0.16,0.84
36009961700,"Census Tract 9617, Cattaraugus County, New York",3554,2799,755,0.21,0.79
36009961800,"Census Tract 9618, Cattaraugus County, New York",4466,3880,586,0.13,0.87
36009962200,"Census Tract 9622, Cattaraugus County, New York",2772,2550,222,0.08,0.92
36011040101,"Census Tract 401.01, Cayuga County, New York",1650,1536,114,0.07,0.93
36011040102,"Census Tract 401.02, Cayuga County, New York",3223,3008,215,0.07,0.93
36011040201,"Census Tract 402.01, Cayuga County, New York",2445,2277,168,0.07,0.93
36011040202,"Census Tract 402.02, Cayuga County, New York",2142,1946,196,0.09,0.91
36011040300,"Census Tract 403, Cayuga County, New York",3905,3576,329,0.08,0.92
36011040400,"Census Tract 404, Cayuga County, New York",4314,3921,393,0.09,0.91
36011040500,"Census Tract 405, Cayuga County, New York",3008,2820,188,0.06,0.94
36011040600,"Census Tract 406, Cayuga County, New York",3304,2978,326,0.1,0.9
36011040700,"Census Tract 407, Cayuga County, New York",3552,3390,162,0.05,0.95
36011040800,"Census Tract 408, Cayuga County, New York",4460,3643,817,0.18,0.82
36011040900,"Census Tract 409, Cayuga County, New York",3827,3541,286,0.07,0.93
36011041001,"Census Tract 410.01, Cayuga County, New York",3051,2640,411,0.13,0.87
36011041002,"Census Tract 410.02, Cayuga County, New York",1655,1434,221,0.13,0.87
36011041101,"Census Tract 411.01, Cayuga County, New York",2477,2269,208,0.08,0.92
36011041102,"Census Tract 411.02, Cayuga County, New York",1531,1309,222,0.15,0.85
36011041201,"Census Tract 412.01, Cayuga County, New York",2227,1971,256,0.11,0.89
36011041202,"Census Tract 412.02, Cayuga County, New York",2611,2416,195,0.07,0.93
36011041300,"Census Tract 413, Cayuga County, New York",3978,3264,714,0.18,0.82
36011041400,"Census Tract 414, Cayuga County, New York",4803,4212,591,0.12,0.88
36011041500,"Census Tract 415, Cayuga County, New York",2745,2340,405,0.15,0.85
36011041600,"Census Tract 416, Cayuga County, New York",2498,2215,283,0.11,0.89
36011041700,"Census Tract 417, Cayuga County, New York",3957,3437,520,0.13,0.87
36011041800,"Census Tract 418, Cayuga County, New York",4799,3823,976,0.2,0.8
36011042100,"Census Tract 421, Cayuga County, New York",4086,2347,1739,0.43,0.57
36011990200,"Census Tract 9902, Cayuga County, New York",0,0,0,0,0
36013030100,"Census Tract 301, Chautauqua County, New York",3413,2468,945,0.28,0.72
36013030200,"Census Tract 302, Chautauqua County, New York",3984,2946,1038,0.26,0.74
36013030300,"Census Tract 303, Chautauqua County, New York",1973,1143,830,0.42,0.58
36013030400,"Census Tract 304, Chautauqua County, New York",4015,3375,640,0.16,0.84
36013030500,"Census Tract 305, Chautauqua County, New York",3284,2189,1095,0.33,0.67
36013030600,"Census Tract 306, Chautauqua County, New York",3436,2552,884,0.26,0.74
36013030700,"Census Tract 307, Chautauqua County, New York",4324,3498,826,0.19,0.81
36013030800,"Census Tract 308, Chautauqua County, New York",4283,3406,877,0.2,0.8
36013035100,"Census Tract 351, Chautauqua County, New York",4313,3794,519,0.12,0.88
36013035300,"Census Tract 353, Chautauqua County, New York",2564,2322,242,0.09,0.91
36013035400,"Census Tract 354, Chautauqua County, New York",3049,1514,1535,0.5,0.5
36013035500,"Census Tract 355, Chautauqua County, New York",2876,1582,1294,0.45,0.55
36013035600,"Census Tract 356, Chautauqua County, New York",3443,2074,1369,0.4,0.6
36013035700,"Census Tract 357, Chautauqua County, New York",3375,1838,1537,0.46,0.54
36013035800,"Census Tract 358, Chautauqua County, New York",3422,2813,609,0.18,0.82
36013035901,"Census Tract 359.01, Chautauqua County, New York",4542,3812,730,0.16,0.84
36013035902,"Census Tract 359.02, Chautauqua County, New York",2159,1522,637,0.3,0.7
36013036000,"Census Tract 360, Chautauqua County, New York",4152,3471,681,0.16,0.84
36013036100,"Census Tract 361, Chautauqua County, New York",4629,4303,326,0.07,0.93
36013036300,"Census Tract 363, Chautauqua County, New York",4309,3462,847,0.2,0.8
36013036401,"Census Tract 364.01, Chautauqua County, New York",2628,2370,258,0.1,0.9
36013036402,"Census Tract 364.02, Chautauqua County, New York",3425,3160,265,0.08,0.92
36013036500,"Census Tract 365, Chautauqua County, New York",4553,4138,415,0.09,0.91
36013036600,"Census Tract 366, Chautauqua County, New York",3330,3101,229,0.07,0.93
36013036700,"Census Tract 367, Chautauqua County, New York",4382,4185,197,0.04,0.96
36013036801,"Census Tract 368.01, Chautauqua County, New York",2241,2109,132,0.06,0.94
36013036802,"Census Tract 368.02, Chautauqua County, New York",2072,1953,119,0.06,0.94
36013036901,"Census Tract 369.01, Chautauqua County, New York",2769,2591,178,0.06,0.94
36013036902,"Census Tract 369.02, Chautauqua County, New York",3135,2953,182,0.06,0.94
36013037000,"Census Tract 370, Chautauqua County, New York",3406,3217,189,0.06,0.94
36013037100,"Census Tract 371, Chautauqua County, New York",4137,3722,415,0.1,0.9
36013037200,"Census Tract 372, Chautauqua County, New York",3728,3358,370,0.1,0.9
36013037300,"Census Tract 373, Chautauqua County, New York",5040,4677,363,0.07,0.93
36013037400,"Census Tract 374, Chautauqua County, New York",3711,3513,198,0.05,0.95
36013037500,"Census Tract 375, Chautauqua County, New York",4853,4557,296,0.06,0.94
36013037600,"Census Tract 376, Chautauqua County, New York",2702,2375,327,0.12,0.88
36013990000,"Census Tract 9900, Chautauqua County, New York",0,0,0,0,0
36015000100,"Census Tract 1, Chemung County, New York",2635,1726,909,0.34,0.66
36015000200,"Census Tract 2, Chemung County, New York",2642,1924,718,0.27,0.73
36015000300,"Census Tract 3, Chemung County, New York",1471,356,1115,0.76,0.24
36015000400,"Census Tract 4, Chemung County, New York",2113,1743,370,0.18,0.82
36015000500,"Census Tract 5, Chemung County, New York",2912,2154,758,0.26,0.74
36015000600,"Census Tract 6, Chemung County, New York",2864,2030,834,0.29,0.71
36015000700,"Census Tract 7, Chemung County, New York",2407,1499,908,0.38,0.62
36015000900,"Census Tract 9, Chemung County, New York",3355,2603,752,0.22,0.78
36015001000,"Census Tract 10, Chemung County, New York",2770,1982,788,0.28,0.72
36015001100,"Census Tract 11, Chemung County, New York",3354,2642,712,0.21,0.79
36015010100,"Census Tract 101, Chemung County, New York",3345,3100,245,0.07,0.93
36015010200,"Census Tract 102, Chemung County, New York",5896,5385,511,0.09,0.91
36015010301,"Census Tract 103.01, Chemung County, New York",4615,3997,618,0.13,0.87
36015010302,"Census Tract 103.02, Chemung County, New York",3176,2832,344,0.11,0.89
36015010400,"Census Tract 104, Chemung County, New York",3552,3196,356,0.1,0.9
36015010500,"Census Tract 105, Chemung County, New York",3009,2525,484,0.16,0.84
36015010600,"Census Tract 106, Chemung County, New York",3013,2644,369,0.12,0.88
36015010701,"Census Tract 107.01, Chemung County, New York",3063,2406,657,0.21,0.79
36015010702,"Census Tract 107.02, Chemung County, New York",4420,4000,420,0.1,0.9
36015010800,"Census Tract 108, Chemung County, New York",3513,3061,452,0.13,0.87
36015010900,"Census Tract 109, Chemung County, New York",5015,4425,590,0.12,0.88
36015011000,"Census Tract 110, Chemung County, New York",3807,3589,218,0.06,0.94
36015011101,"Census Tract 111.01, Chemung County, New York",2934,2557,377,0.13,0.87
36015011102,"Census Tract 111.02, Chemung County, New York",3827,3371,456,0.12,0.88
36015011200,"Census Tract 112, Chemung County, New York",4440,3812,628,0.14,0.86
36017970101,"Census Tract 9701.01, Chenango County, New York",3021,2850,171,0.06,0.94
36017970102,"Census Tract 9701.02, Chenango County, New York",2876,2669,207,0.07,0.93
36017970201,"Census Tract 9702.01, Chenango County, New York",1868,1737,131,0.07,0.93
36017970202,"Census Tract 9702.02, Chenango County, New York",2163,1970,193,0.09,0.91
36017970300,"Census Tract 9703, Chenango County, New York",3932,3534,398,0.1,0.9
36017970400,"Census Tract 9704, Chenango County, New York",3119,2645,474,0.15,0.85
36017970501,"Census Tract 9705.01, Chenango County, New York",2334,2086,248,0.11,0.89
36017970502,"Census Tract 9705.02, Chenango County, New York",2975,2663,312,0.1,0.9
36017970601,"Census Tract 9706.01, Chenango County, New York",3822,3489,333,0.09,0.91
36017970602,"Census Tract 9706.02, Chenango County, New York",3554,3296,258,0.07,0.93
36017970700,"Census Tract 9707, Chenango County, New York",2214,2001,213,0.1,0.9
36017970801,"Census Tract 9708.01, Chenango County, New York",3660,3424,236,0.06,0.94
36017970802,"Census Tract 9708.02, Chenango County, New York",3570,3326,244,0.07,0.93
36017970901,"Census Tract 9709.01, Chenango County, New York",2632,2451,181,0.07,0.93
36017970902,"Census Tract 9709.02, Chenango County, New York",2111,1935,176,0.08,0.92
36017971000,"Census Tract 9710, Chenango County, New York",3369,3077,292,0.09,0.91
36019100101,"Census Tract 1001.01, Clinton County, New York",2664,2455,209,0.08,0.92
36019100102,"Census Tract 1001.02, Clinton County, New York",3081,2822,259,0.08,0.92
36019100200,"Census Tract 1002, Clinton County, New York",4096,3767,329,0.08,0.92
36019100600,"Census Tract 1006, Clinton County, New York",5508,5052,456,0.08,0.92
36019100700,"Census Tract 1007, Clinton County, New York",3606,3387,219,0.06,0.94
36019100800,"Census Tract 1008, Clinton County, New York",4682,4187,495,0.11,0.89
36019100901,"Census Tract 1009.01, Clinton County, New York",2864,2397,467,0.16,0.84
36019100902,"Census Tract 1009.02, Clinton County, New York",2078,1692,386,0.19,0.81
36019101000,"Census Tract 1010, Clinton County, New York",4150,3589,561,0.14,0.86
36019101600,"Census Tract 1016, Clinton County, New York",1623,1422,201,0.12,0.88
36019101901,"Census Tract 1019.01, Clinton County, New York",4820,4356,464,0.1,0.9
36019101902,"Census Tract 1019.02, Clinton County, New York",1212,1074,138,0.11,0.89
36019102100,"Census Tract 1021, Clinton County, New York",1975,1760,215,0.11,0.89
36019102200,"Census Tract 1022, Clinton County, New York",3199,2682,517,0.16,0.84
36019102800,"Census Tract 1028, Clinton County, New York",3484,3149,335,0.1,0.9
36019103000,"Census Tract 1030, Clinton County, New York",2232,1376,856,0.38,0.62
36019103100,"Census Tract 1031, Clinton County, New York",2841,2148,693,0.24,0.76
36019103200,"Census Tract 1032, Clinton County, New York",2477,2144,333,0.13,0.87
36019103512,"Census Tract 1035.12, Clinton County, New York",6748,4717,2031,0.3,0.7
36019103800,"Census Tract 1038, Clinton County, New York",5702,5331,371,0.07,0.93
36019103900,"Census Tract 1039, Clinton County, New York",4885,4457,428,0.09,0.91
36019104200,"Census Tract 1042, Clinton County, New York",5916,5287,629,0.11,0.89
36021000100,"Census Tract 1, Columbia County, New York",2514,2140,374,0.15,0.85
36021000200,"Census Tract 2, Columbia County, New York",1570,1414,156,0.1,0.9
36021000300,"Census Tract 3, Columbia County, New York",4104,3692,412,0.1,0.9
36021000401,"Census Tract 4.01, Columbia County, New York",2384,2227,157,0.07,0.93
36021000402,"Census Tract 4.02, Columbia County, New York",5946,5063,883,0.15,0.85
36021000500,"Census Tract 5, Columbia County, New York",1931,1657,274,0.14,0.86
36021000600,"Census Tract 6, Columbia County, New York",2670,2117,553,0.21,0.79
36021000700,"Census Tract 7, Columbia County, New York",5303,4673,630,0.12,0.88
36021000800,"Census Tract 8, Columbia County, New York",1625,1492,133,0.08,0.92
36021000900,"Census Tract 9, Columbia County, New York",1831,1616,215,0.12,0.88
36021001000,"Census Tract 10, Columbia County, New York",6058,5168,890,0.15,0.85
36021001100,"Census Tract 11, Columbia County, New York",4473,3153,1320,0.3,0.7
36021001200,"Census Tract 12, Columbia County, New York",3168,1534,1634,0.52,0.48
36021001300,"Census Tract 13, Columbia County, New York",2726,1668,1058,0.39,0.61
36021001400,"Census Tract 14, Columbia County, New York",3628,3125,503,0.14,0.86
36021001500,"Census Tract 15, Columbia County, New York",1231,1057,174,0.14,0.86
36021001600,"Census Tract 16, Columbia County, New York",3346,2883,463,0.14,0.86
36021001700,"Census Tract 17, Columbia County, New York",1440,1259,181,0.13,0.87
36021001800,"Census Tract 18, Columbia County, New York",1628,1412,216,0.13,0.87
36021001900,"Census Tract 19, Columbia County, New York",2058,1739,319,0.16,0.84
36021002000,"Census Tract 20, Columbia County, New York",1936,1706,230,0.12,0.88
36023970100,"Census Tract 9701, Cortland County, New York",3420,3103,317,0.09,0.91
36023970201,"Census Tract 9702.01, Cortland County, New York",2434,2279,155,0.06,0.94
36023970202,"Census Tract 9702.02, Cortland County, New York",3254,3034,220,0.07,0.93
36023970300,"Census Tract 9703, Cortland County, New York",3039,2767,272,0.09,0.91
36023970400,"Census Tract 9704, Cortland County, New York",2812,2570,242,0.09,0.91
36023970500,"Census Tract 9705, Cortland County, New York",3656,3146,510,0.14,0.86
36023970600,"Census Tract 9706, Cortland County, New York",3049,2529,520,0.17,0.83
36023970700,"Census Tract 9707, Cortland County, New York",4000,3543,457,0.11,0.89
36023970800,"Census Tract 9708, Cortland County, New York",2781,1710,1071,0.39,0.61
36023970900,"Census Tract 9709, Cortland County, New York",4070,3398,672,0.17,0.83
36023971000,"Census Tract 9710, Cortland County, New York",5597,4788,809,0.14,0.86
36023971100,"Census Tract 9711, Cortland County, New York",4601,4190,411,0.09,0.91
36023971200,"Census Tract 9712, Cortland County, New York",4096,3744,352,0.09,0.91
36025970101,"Census Tract 9701.01, Delaware County, New York",1442,1293,149,0.1,0.9
36025970102,"Census Tract 9701.02, Delaware County, New York",2955,2641,314,0.11,0.89
36025970200,"Census Tract 9702, Delaware County, New York",3028,2768,260,0.09,0.91
36025970300,"Census Tract 9703, Delaware County, New York",2288,2069,219,0.1,0.9
36025970401,"Census Tract 9704.01, Delaware County, New York",1829,1651,178,0.1,0.9
36025970402,"Census Tract 9704.02, Delaware County, New York",3707,3194,513,0.14,0.86
36025970501,"Census Tract 9705.01, Delaware County, New York",2165,1763,402,0.19,0.81
36025970502,"Census Tract 9705.02, Delaware County, New York",1791,1632,159,0.09,0.91
36025970601,"Census Tract 9706.01, Delaware County, New York",2398,2160,238,0.1,0.9
36025970602,"Census Tract 9706.02, Delaware County, New York",2872,2605,267,0.09,0.91
36025970700,"Census Tract 9707, Delaware County, New York",2251,2038,213,0.09,0.91
36025970800,"Census Tract 9708, Delaware County, New York",3528,3123,405,0.11,0.89
36025970900,"Census Tract 9709, Delaware County, New York",1267,627,640,0.51,0.49
36025971000,"Census Tract 9710, Delaware County, New York",2658,2368,290,0.11,0.89
36025971100,"Census Tract 9711, Delaware County, New York",2247,2060,187,0.08,0.92
36025971200,"Census Tract 9712, Delaware County, New York",3336,2789,547,0.16,0.84
36025971300,"Census Tract 9713, Delaware County, New York",1782,1590,192,0.11,0.89
36025971400,"Census Tract 9714, Delaware County, New York",2764,2450,314,0.11,0.89
36027010000,"Census Tract 100, Dutchess County, New York",3769,2974,795,0.21,0.79
36027020003,"Census Tract 200.03, Dutchess County, New York",4226,3204,1022,0.24,0.76
36027020004,"Census Tract 200.04, Dutchess County, New York",2853,2282,571,0.2,0.8
36027020005,"Census Tract 200.05, Dutchess County, New York",5272,4216,1056,0.2,0.8
36027030000,"Census Tract 300, Dutchess County, New York",4037,3521,516,0.13,0.87
36027040001,"Census Tract 400.01, Dutchess County, New York",4595,3236,1359,0.3,0.7
36027040003,"Census Tract 400.03, Dutchess County, New York",3820,2500,1320,0.35,0.65
36027050102,"Census Tract 501.02, Dutchess County, New York",4180,3068,1112,0.27,0.73
36027050103,"Census Tract 501.03, Dutchess County, New York",5482,4235,1247,0.23,0.77
36027050104,"Census Tract 501.04, Dutchess County, New York",6837,5056,1781,0.26,0.74
36027050203,"Census Tract 502.03, Dutchess County, New York",5212,3898,1314,0.25,0.75
36027050204,"Census Tract 502.04, Dutchess County, New York",2812,2093,719,0.26,0.74
36027050205,"Census Tract 502.05, Dutchess County, New York",5184,4053,1131,0.22,0.78
36027060100,"Census Tract 601, Dutchess County, New York",6189,3221,2968,0.48,0.52
36027060201,"Census Tract 602.01, Dutchess County, New York",3297,2306,991,0.3,0.7
36027060202,"Census Tract 602.02, Dutchess County, New York",4302,3086,1216,0.28,0.72
36027060301,"Census Tract 603.01, Dutchess County, New York",4334,3156,1178,0.27,0.73
36027060302,"Census Tract 603.02, Dutchess County, New York",2658,1619,1039,0.39,0.61
36027060400,"Census Tract 604, Dutchess County, New York",2166,1478,688,0.32,0.68
36027070101,"Census Tract 701.01, Dutchess County, New York",4382,3484,898,0.2,0.8
36027070102,"Census Tract 701.02, Dutchess County, New York",3379,2671,708,0.21,0.79
36027070201,"Census Tract 702.01, Dutchess County, New York",2979,2230,749,0.25,0.75
36027070301,"Census Tract 703.01, Dutchess County, New York",6008,4543,1465,0.24,0.76
36027070401,"Census Tract 704.01, Dutchess County, New York",4273,2477,1796,0.42,0.58
36027080103,"Census Tract 801.03, Dutchess County, New York",5116,3590,1526,0.3,0.7
36027080104,"Census Tract 801.04, Dutchess County, New York",3678,2885,793,0.22,0.78
36027080201,"Census Tract 802.01, Dutchess County, New York",4588,3366,1222,0.27,0.73
36027080202,"Census Tract 802.02, Dutchess County, New York",2593,2011,582,0.22,0.78
36027090000,"Census Tract 900, Dutchess County, New York",2245,1912,333,0.15,0.85
36027100000,"Census Tract 1000, Dutchess County, New York",2971,2318,653,0.22,0.78
36027110003,"Census Tract 1100.03, Dutchess County, New York",3780,3073,707,0.19,0.81
36027110004,"Census Tract 1100.04, Dutchess County, New York",2237,1747,490,0.22,0.78
36027110005,"Census Tract 1100.05, Dutchess County, New York",1995,1376,619,0.31,0.69
36027120000,"Census Tract 1200, Dutchess County, New York",2218,1921,297,0.13,0.87
36027130003,"Census Tract 1300.03, Dutchess County, New York",5341,4159,1182,0.22,0.78
36027130004,"Census Tract 1300.04, Dutchess County, New York",1737,1443,294,0.17,0.83
36027130005,"Census Tract 1300.05, Dutchess County, New York",2721,2215,506,0.19,0.81
36027140101,"Census Tract 1401.01, Dutchess County, New York",7043,4575,2468,0.35,0.65
36027140201,"Census Tract 1402.01, Dutchess County, New York",2437,1505,932,0.38,0.62
36027140202,"Census Tract 1402.02, Dutchess County, New York",4835,3146,1689,0.35,0.65
36027140301,"Census Tract 1403.01, Dutchess County, New York",3024,1549,1475,0.49,0.51
36027140302,"Census Tract 1403.02, Dutchess County, New York",2876,1325,1551,0.54,0.46
36027140400,"Census Tract 1404, Dutchess County, New York",5360,3767,1593,0.3,0.7
36027140500,"Census Tract 1405, Dutchess County, New York",2650,1517,1133,0.43,0.57
36027140602,"Census Tract 1406.02, Dutchess County, New York",2872,1791,1081,0.38,0.62
36027140700,"Census Tract 1407, Dutchess County, New York",6761,4685,2076,0.31,0.69
36027140801,"Census Tract 1408.01, Dutchess County, New York",2838,1845,993,0.35,0.65
36027150003,"Census Tract 1500.03, Dutchess County, New York",1782,1443,339,0.19,0.81
36027150004,"Census Tract 1500.04, Dutchess County, New York",3481,2986,495,0.14,0.86
36027150005,"Census Tract 1500.05, Dutchess County, New York",2715,2342,373,0.14,0.86
36027150006,"Census Tract 1500.06, Dutchess County, New York",1975,1610,365,0.18,0.82
36027160003,"Census Tract 1600.03, Dutchess County, New York",2429,2106,323,0.13,0.87
36027160004,"Census Tract 1600.04, Dutchess County, New York",2470,2127,343,0.14,0.86
36027160005,"Census Tract 1600.05, Dutchess County, New York",2697,2277,420,0.16,0.84
36027170000,"Census Tract 1700, Dutchess County, New York",3682,3073,609,0.17,0.83
36027180001,"Census Tract 1800.01, Dutchess County, New York",4558,3926,632,0.14,0.86
36027190101,"Census Tract 1901.01, Dutchess County, New York",3870,2754,1116,0.29,0.71
36027190102,"Census Tract 1901.02, Dutchess County, New York",1865,1278,587,0.31,0.69
36027190203,"Census Tract 1902.03, Dutchess County, New York",2644,1724,920,0.35,0.65
36027190204,"Census Tract 1902.04, Dutchess County, New York",5404,3798,1606,0.3,0.7
36027190301,"Census Tract 1903.01, Dutchess County, New York",3609,2217,1392,0.39,0.61
36027190401,"Census Tract 1904.01, Dutchess County, New York",2320,1666,654,0.28,0.72
36027190402,"Census Tract 1904.02, Dutchess County, New York",3328,2222,1106,0.33,0.67
36027200001,"Census Tract 2000.01, Dutchess County, New York",3067,2490,577,0.19,0.81
36027200002,"Census Tract 2000.02, Dutchess County, New York",1455,1176,279,0.19,0.81
36027210101,"Census Tract 2101.01, Dutchess County, New York",5437,3307,2130,0.39,0.61
36027210201,"Census Tract 2102.01, Dutchess County, New York",4128,2148,1980,0.48,0.52
36027210301,"Census Tract 2103.01, Dutchess County, New York",4158,2740,1418,0.34,0.66
36027220101,"Census Tract 2201.01, Dutchess County, New York",4045,1523,2522,0.62,0.38
36027220102,"Census Tract 2201.02, Dutchess County, New York",856,256,600,0.7,0.3
36027220201,"Census Tract 2202.01, Dutchess County, New York",3424,738,2686,0.78,0.22
36027220300,"Census Tract 2203, Dutchess County, New York",4938,663,4275,0.87,0.13
36027220700,"Census Tract 2207, Dutchess County, New York",2576,834,1742,0.68,0.32
36027220801,"Census Tract 2208.01, Dutchess County, New York",3948,1953,1995,0.51,0.49
36027220901,"Census Tract 2209.01, Dutchess County, New York",4272,1557,2715,0.64,0.36
36027221001,"Census Tract 2210.01, Dutchess County, New York",3636,2568,1068,0.29,0.71
36027221100,"Census Tract 2211, Dutchess County, New York",3882,761,3121,0.8,0.2
36027300000,"Census Tract 3000, Dutchess County, New York",6103,3257,2846,0.47,0.53
36027410000,"Census Tract 4100, Dutchess County, New York",3848,2116,1732,0.45,0.55
36027610000,"Census Tract 6100, Dutchess County, New York",1821,250,1571,0.86,0.14
36027640001,"Census Tract 6400.01, Dutchess County, New York",767,168,599,0.78,0.22
36027640002,"Census Tract 6400.02, Dutchess County, New York",559,113,446,0.8,0.2
36029000110,"Census Tract 1.10, Erie County, New York",2673,1779,894,0.33,0.67
36029000200,"Census Tract 2, Erie County, New York",4450,2902,1548,0.35,0.65
36029000500,"Census Tract 5, Erie County, New York",2112,1512,600,0.28,0.72
36029000600,"Census Tract 6, Erie County, New York",4563,3836,727,0.16,0.84
36029000700,"Census Tract 7, Erie County, New York",3551,3193,358,0.1,0.9
36029000800,"Census Tract 8, Erie County, New York",4636,3824,812,0.18,0.82
36029000900,"Census Tract 9, Erie County, New York",2349,1850,499,0.21,0.79
36029001000,"Census Tract 10, Erie County, New York",6270,4264,2006,0.32,0.68
36029001100,"Census Tract 11, Erie County, New York",3324,2449,875,0.26,0.74
36029001403,"Census Tract 14.03, Erie County, New York",1781,37,1744,0.98,0.02
36029001404,"Census Tract 14.04, Erie County, New York",1202,28,1174,0.98,0.02
36029001500,"Census Tract 15, Erie County, New York",1612,144,1468,0.91,0.09
36029001601,"Census Tract 16.01, Erie County, New York",1616,260,1356,0.84,0.16
36029001602,"Census Tract 16.02, Erie County, New York",1358,163,1195,0.88,0.12
36029001700,"Census Tract 17, Erie County, New York",1908,1017,891,0.47,0.53
36029001900,"Census Tract 19, Erie County, New York",3189,2340,849,0.27,0.73
36029002300,"Census Tract 23, Erie County, New York",3566,2056,1510,0.42,0.58
36029002400,"Census Tract 24, Erie County, New York",4647,2279,2368,0.51,0.49
36029002502,"Census Tract 25.02, Erie County, New York",2048,203,1845,0.9,0.1
36029002703,"Census Tract 27.03, Erie County, New York",1843,181,1662,0.9,0.1
36029002704,"Census Tract 27.04, Erie County, New York",2335,175,2160,0.93,0.07
36029002801,"Census Tract 28.01, Erie County, New York",1512,228,1284,0.85,0.15
36029002802,"Census Tract 28.02, Erie County, New York",1138,167,971,0.85,0.15
36029002900,"Census Tract 29, Erie County, New York",2475,148,2327,0.94,0.06
36029003000,"Census Tract 30, Erie County, New York",3092,330,2762,0.89,0.11
36029003100,"Census Tract 31, Erie County, New York",2361,185,2176,0.92,0.08
36029003301,"Census Tract 33.01, Erie County, New York",3800,395,3405,0.9,0.1
36029003302,"Census Tract 33.02, Erie County, New York",3877,202,3675,0.95,0.05
36029003400,"Census Tract 34, Erie County, New York",3588,95,3493,0.97,0.03
36029003501,"Census Tract 35.01, Erie County, New York",1722,60,1662,0.97,0.03
36029003502,"Census Tract 35.02, Erie County, New York",2272,58,2214,0.97,0.03
36029003600,"Census Tract 36, Erie County, New York",2826,177,2649,0.94,0.06
36029003700,"Census Tract 37, Erie County, New York",4909,299,4610,0.94,0.06
36029003800,"Census Tract 38, Erie County, New York",3181,289,2892,0.91,0.09
36029003901,"Census Tract 39.01, Erie County, New York",1126,81,1045,0.93,0.07
36029004002,"Census Tract 40.02, Erie County, New York",1495,286,1209,0.81,0.19
36029004003,"Census Tract 40.03, Erie County, New York",3251,192,3059,0.94,0.06
36029004100,"Census Tract 41, Erie County, New York",4813,315,4498,0.93,0.07
36029004200,"Census Tract 42, Erie County, New York",3689,147,3542,0.96,0.04
36029004300,"Census Tract 43, Erie County, New York",6373,658,5715,0.9,0.1
36029004401,"Census Tract 44.01, Erie County, New York",4475,198,4277,0.96,0.04
36029004402,"Census Tract 44.02, Erie County, New York",2900,56,2844,0.98,0.02
36029004500,"Census Tract 45, Erie County, New York",5529,3524,2005,0.36,0.64
36029004601,"Census Tract 46.01, Erie County, New York",3394,1656,1738,0.51,0.49
36029004701,"Census Tract 47.01, Erie County, New York",2766,221,2545,0.92,0.08
36029004702,"Census Tract 47.02, Erie County, New York",4752,1304,3448,0.73,0.27
36029004800,"Census Tract 48, Erie County, New York",3874,3092,782,0.2,0.8
36029004901,"Census Tract 49.01, Erie County, New York",1418,1013,405,0.29,0.71
36029004902,"Census Tract 49.02, Erie County, New York",4643,3209,1434,0.31,0.69
36029005000,"Census Tract 50, Erie County, New York",2538,1534,1004,0.4,0.6
36029005100,"Census Tract 51, Erie County, New York",4616,2775,1841,0.4,0.6
36029005201,"Census Tract 52.01, Erie County, New York",3104,2205,899,0.29,0.71
36029005202,"Census Tract 52.02, Erie County, New York",2778,777,2001,0.72,0.28
36029005300,"Census Tract 53, Erie County, New York",1184,627,557,0.47,0.53
36029005400,"Census Tract 54, Erie County, New York",3867,2855,1012,0.26,0.74
36029005500,"Census Tract 55, Erie County, New York",4363,1810,2553,0.59,0.41
36029005600,"Census Tract 56, Erie County, New York",4682,1583,3099,0.66,0.34
36029005700,"Census Tract 57, Erie County, New York",3516,1038,2478,0.7,0.3
36029005801,"Census Tract 58.01, Erie County, New York",3641,1589,2052,0.56,0.44
36029005802,"Census Tract 58.02, Erie County, New York",5582,1738,3844,0.69,0.31
36029005900,"Census Tract 59, Erie County, New York",4051,1521,2530,0.62,0.38
36029006100,"Census Tract 61, Erie County, New York",5155,1413,3742,0.73,0.27
36029006301,"Census Tract 63.01, Erie County, New York",4405,3163,1242,0.28,0.72
36029006302,"Census Tract 63.02, Erie County, New York",2693,2299,394,0.15,0.85
36029006501,"Census Tract 65.01, Erie County, New York",2999,1990,1009,0.34,0.66
36029006601,"Census Tract 66.01, Erie County, New York",2498,1438,1060,0.42,0.58
36029006602,"Census Tract 66.02, Erie County, New York",2382,1694,688,0.29,0.71
36029006701,"Census Tract 67.01, Erie County, New York",3412,2171,1241,0.36,0.64
36029006702,"Census Tract 67.02, Erie County, New York",3314,2156,1158,0.35,0.65
36029006801,"Census Tract 68.01, Erie County, New York",1063,596,467,0.44,0.56
36029006802,"Census Tract 68.02, Erie County, New York",2835,2039,796,0.28,0.72
36029006901,"Census Tract 69.01, Erie County, New York",4201,877,3324,0.79,0.21
36029006903,"Census Tract 69.03, Erie County, New York",1473,643,830,0.56,0.44
36029006904,"Census Tract 69.04, Erie County, New York",2440,1129,1311,0.54,0.46
36029007000,"Census Tract 70, Erie County, New York",3432,961,2471,0.72,0.28
36029007102,"Census Tract 71.02, Erie County, New York",2482,749,1733,0.7,0.3
36029007103,"Census Tract 71.03, Erie County, New York",1397,289,1108,0.79,0.21
36029007104,"Census Tract 71.04, Erie County, New York",2646,341,2305,0.87,0.13
36029007202,"Census Tract 72.02, Erie County, New York",1564,713,851,0.54,0.46
36029007303,"Census Tract 73.03, Erie County, New York",7031,6039,992,0.14,0.86
36029007304,"Census Tract 73.04, Erie County, New York",6283,5454,829,0.13,0.87
36029007305,"Census Tract 73.05, Erie County, New York",2637,2377,260,0.1,0.9
36029007306,"Census Tract 73.06, Erie County, New York",5438,4854,584,0.11,0.89
36029007600,"Census Tract 76, Erie County, New York",2873,2604,269,0.09,0.91
36029007700,"Census Tract 77, Erie County, New York",4690,4037,653,0.14,0.86
36029007800,"Census Tract 78, Erie County, New York",5303,4729,574,0.11,0.89
36029007901,"Census Tract 79.01, Erie County, New York",3025,2552,473,0.16,0.84
36029007902,"Census Tract 79.02, Erie County, New York",5791,5224,567,0.1,0.9
36029007903,"Census Tract 79.03, Erie County, New York",3348,3001,347,0.1,0.9
36029007904,"Census Tract 79.04, Erie County, New York",3169,2811,358,0.11,0.89
36029007905,"Census Tract 79.05, Erie County, New York",4488,3917,571,0.13,0.87
36029008001,"Census Tract 80.01, Erie County, New York",5598,4387,1211,0.22,0.78
36029008002,"Census Tract 80.02, Erie County, New York",5246,4404,842,0.16,0.84
36029008003,"Census Tract 80.03, Erie County, New York",5159,4094,1065,0.21,0.79
36029008101,"Census Tract 81.01, Erie County, New York",5833,5076,757,0.13,0.87
36029008102,"Census Tract 81.02, Erie County, New York",4493,3990,503,0.11,0.89
36029008201,"Census Tract 82.01, Erie County, New York",2534,2197,337,0.13,0.87
36029008202,"Census Tract 82.02, Erie County, New York",3871,3258,613,0.16,0.84
36029008300,"Census Tract 83, Erie County, New York",2491,1500,991,0.4,0.6
36029008400,"Census Tract 84, Erie County, New York",2385,1830,555,0.23,0.77
36029008500,"Census Tract 85, Erie County, New York",2569,2112,457,0.18,0.82
36029008600,"Census Tract 86, Erie County, New York",4713,4066,647,0.14,0.86
36029008700,"Census Tract 87, Erie County, New York",4666,3795,871,0.19,0.81
36029008800,"Census Tract 88, Erie County, New York",3257,2588,669,0.21,0.79
36029008900,"Census Tract 89, Erie County, New York",4200,3749,451,0.11,0.89
36029009004,"Census Tract 90.04, Erie County, New York",3486,2912,574,0.16,0.84
36029009007,"Census Tract 90.07, Erie County, New York",7707,6005,1702,0.22,0.78
36029009008,"Census Tract 90.08, Erie County, New York",5355,4245,1110,0.21,0.79
36029009009,"Census Tract 90.09, Erie County, New York",5905,4713,1192,0.2,0.8
36029009010,"Census Tract 90.10, Erie County, New York",6221,4813,1408,0.23,0.77
36029009011,"Census Tract 90.11, Erie County, New York",3127,2586,541,0.17,0.83
36029009012,"Census Tract 90.12, Erie County, New York",4502,3139,1363,0.3,0.7
36029009104,"Census Tract 91.04, Erie County, New York",4165,3501,664,0.16,0.84
36029009106,"Census Tract 91.06, Erie County, New York",3144,2453,691,0.22,0.78
36029009107,"Census Tract 91.07, Erie County, New York",6150,3714,2436,0.4,0.6
36029009109,"Census Tract 91.09, Erie County, New York",3282,2284,998,0.3,0.7
36029009110,"Census Tract 91.10, Erie County, New York",6512,3549,2963,0.46,0.54
36029009112,"Census Tract 91.12, Erie County, New York",3295,2560,735,0.22,0.78
36029009113,"Census Tract 91.13, Erie County, New York",6787,5561,1226,0.18,0.82
36029009114,"Census Tract 91.14, Erie County, New York",4186,3258,928,0.22,0.78
36029009115,"Census Tract 91.15, Erie County, New York",4478,2196,2282,0.51,0.49
36029009116,"Census Tract 91.16, Erie County, New York",5472,3780,1692,0.31,0.69
36029009200,"Census Tract 92, Erie County, New York",4570,2944,1626,0.36,0.64
36029009301,"Census Tract 93.01, Erie County, New York",5625,2708,2917,0.52,0.48
36029009302,"Census Tract 93.02, Erie County, New York",2767,1936,831,0.3,0.7
36029009401,"Census Tract 94.01, Erie County, New York",5763,4360,1403,0.24,0.76
36029009402,"Census Tract 94.02, Erie County, New York",4290,3754,536,0.12,0.88
36029009501,"Census Tract 95.01, Erie County, New York",5199,4153,1046,0.2,0.8
36029009503,"Census Tract 95.03, Erie County, New York",2559,2170,389,0.15,0.85
36029009504,"Census Tract 95.04, Erie County, New York",4097,3450,647,0.16,0.84
36029009601,"Census Tract 96.01, Erie County, New York",1441,1117,324,0.22,0.78
36029009602,"Census Tract 96.02, Erie County, New York",5310,4212,1098,0.21,0.79
36029009701,"Census Tract 97.01, Erie County, New York",3056,2627,429,0.14,0.86
36029009702,"Census Tract 97.02, Erie County, New York",4481,4006,475,0.11,0.89
36029009800,"Census Tract 98, Erie County, New York",1712,1528,184,0.11,0.89
36029009900,"Census Tract 99, Erie County, New York",3775,3045,730,0.19,0.81
36029010001,"Census Tract 100.01, Erie County, New York",2934,2426,508,0.17,0.83
36029010002,"Census Tract 100.02, Erie County, New York",4434,3828,606,0.14,0.86
36029010003,"Census Tract 100.03, Erie County, New York",4084,3078,1006,0.25,0.75
36029010101,"Census Tract 101.01, Erie County, New York",4566,3752,814,0.18,0.82
36029010102,"Census Tract 101.02, Erie County, New York",3903,2261,1642,0.42,0.58
36029010103,"Census Tract 101.03, Erie County, New York",3864,3222,642,0.17,0.83
36029010201,"Census Tract 102.01, Erie County, New York",2727,1587,1140,0.42,0.58
36029010202,"Census Tract 102.02, Erie County, New York",4018,1328,2690,0.67,0.33
36029010300,"Census Tract 103, Erie County, New York",1356,398,958,0.71,0.29
36029010400,"Census Tract 104, Erie County, New York",2516,938,1578,0.63,0.37
36029010500,"Census Tract 105, Erie County, New York",2435,1321,1114,0.46,0.54
36029010600,"Census Tract 106, Erie County, New York",2581,1987,594,0.23,0.77
36029010700,"Census Tract 107, Erie County, New York",2749,2050,699,0.25,0.75
36029010803,"Census Tract 108.03, Erie County, New York",1992,1712,280,0.14,0.86
36029010804,"Census Tract 108.04, Erie County, New York",4113,3703,410,0.1,0.9
36029010805,"Census Tract 108.05, Erie County, New York",5036,4675,361,0.07,0.93
36029010807,"Census Tract 108.07, Erie County, New York",5490,4438,1052,0.19,0.81
36029010808,"Census Tract 108.08, Erie County, New York",3928,2916,1012,0.26,0.74
36029010809,"Census Tract 108.09, Erie County, New York",3261,2929,332,0.1,0.9
36029010901,"Census Tract 109.01, Erie County, New York",2336,2031,305,0.13,0.87
36029010902,"Census Tract 109.02, Erie County, New York",4540,3491,1049,0.23,0.77
36029011000,"Census Tract 110, Erie County, New York",1824,1501,323,0.18,0.82
36029011100,"Census Tract 111, Erie County, New York",2166,1830,336,0.16,0.84
36029011201,"Census Tract 112.01, Erie County, New York",1441,1366,75,0.05,0.95
36029011202,"Census Tract 112.02, Erie County, New York",5370,5055,315,0.06,0.94
36029011300,"Census Tract 113, Erie County, New York",4624,4171,453,0.1,0.9
36029011400,"Census Tract 114, Erie County, New York",2333,1906,427,0.18,0.82
36029011500,"Census Tract 115, Erie County, New York",1487,1293,194,0.13,0.87
36029011600,"Census Tract 116, Erie County, New York",2170,1911,259,0.12,0.88
36029011700,"Census Tract 117, Erie County, New York",3988,3609,379,0.1,0.9
36029011800,"Census Tract 118, Erie County, New York",3658,3389,269,0.07,0.93
36029012001,"Census Tract 120.01, Erie County, New York",4677,4253,424,0.09,0.91
36029012002,"Census Tract 120.02, Erie County, New York",3755,3442,313,0.08,0.92
36029012003,"Census Tract 120.03, Erie County, New York",5067,4729,338,0.07,0.93
36029012300,"Census Tract 123, Erie County, New York",3843,2702,1141,0.3,0.7
36029012400,"Census Tract 124, Erie County, New York",2364,1801,563,0.24,0.76
36029012501,"Census Tract 125.01, Erie County, New York",4931,4152,779,0.16,0.84
36029012502,"Census Tract 125.02, Erie County, New York",1842,1662,180,0.1,0.9
36029012800,"Census Tract 128, Erie County, New York",2539,2211,328,0.13,0.87
36029012902,"Census Tract 129.02, Erie County, New York",4129,3734,395,0.1,0.9
36029012903,"Census Tract 129.03, Erie County, New York",2938,2601,337,0.11,0.89
36029012904,"Census Tract 129.04, Erie County, New York",4133,3602,531,0.13,0.87
36029013001,"Census Tract 130.01, Erie County, New York",2996,2662,334,0.11,0.89
36029013002,"Census Tract 130.02, Erie County, New York",6053,5518,535,0.09,0.91
36029013101,"Census Tract 131.01, Erie County, New York",6415,5917,498,0.08,0.92
36029013103,"Census Tract 131.03, Erie County, New York",4541,4191,350,0.08,0.92
36029013104,"Census Tract 131.04, Erie County, New York",4486,4168,318,0.07,0.93
36029013201,"Census Tract 132.01, Erie County, New York",6236,5690,546,0.09,0.91
36029013202,"Census Tract 132.02, Erie County, New York",5440,5023,417,0.08,0.92
36029013300,"Census Tract 133, Erie County, New York",3585,3355,230,0.06,0.94
36029013400,"Census Tract 134, Erie County, New York",6594,6112,482,0.07,0.93
36029013501,"Census Tract 135.01, Erie County, New York",7309,6848,461,0.06,0.94
36029013502,"Census Tract 135.02, Erie County, New York",7120,6641,479,0.07,0.93
36029013600,"Census Tract 136, Erie County, New York",2942,2714,228,0.08,0.92
36029013701,"Census Tract 137.01, Erie County, New York",6368,5860,508,0.08,0.92
36029013702,"Census Tract 137.02, Erie County, New York",5947,5471,476,0.08,0.92
36029013801,"Census Tract 138.01, Erie County, New York",2685,2554,131,0.05,0.95
36029013802,"Census Tract 138.02, Erie County, New York",5384,5084,300,0.06,0.94
36029013900,"Census Tract 139, Erie County, New York",2180,2082,98,0.04,0.96
36029014000,"Census Tract 140, Erie County, New York",3694,3492,202,0.05,0.95
36029014101,"Census Tract 141.01, Erie County, New York",6404,6037,367,0.06,0.94
36029014102,"Census Tract 141.02, Erie County, New York",5317,5066,251,0.05,0.95
36029014204,"Census Tract 142.04, Erie County, New York",4810,4493,317,0.07,0.93
36029014206,"Census Tract 142.06, Erie County, New York",7957,7410,547,0.07,0.93
36029014207,"Census Tract 142.07, Erie County, New York",5404,4954,450,0.08,0.92
36029014208,"Census Tract 142.08, Erie County, New York",7058,6375,683,0.1,0.9
36029014209,"Census Tract 142.09, Erie County, New York",3921,3697,224,0.06,0.94
36029014300,"Census Tract 143, Erie County, New York",5763,5385,378,0.07,0.93
36029014400,"Census Tract 144, Erie County, New York",4264,3865,399,0.09,0.91
36029014501,"Census Tract 145.01, Erie County, New York",3601,3312,289,0.08,0.92
36029014502,"Census Tract 145.02, Erie County, New York",2328,2016,312,0.13,0.87
36029014601,"Census Tract 146.01, Erie County, New York",5261,4603,658,0.13,0.87
36029014603,"Census Tract 146.03, Erie County, New York",4753,3901,852,0.18,0.82
36029014605,"Census Tract 146.05, Erie County, New York",4041,3481,560,0.14,0.86
36029014606,"Census Tract 146.06, Erie County, New York",4273,3550,723,0.17,0.83
36029014701,"Census Tract 147.01, Erie County, New York",5771,5301,470,0.08,0.92
36029014703,"Census Tract 147.03, Erie County, New York",4731,4215,516,0.11,0.89
36029014704,"Census Tract 147.04, Erie County, New York",4120,3900,220,0.05,0.95
36029014801,"Census Tract 148.01, Erie County, New York",2604,2363,241,0.09,0.91
36029014804,"Census Tract 148.04, Erie County, New York",3995,3748,247,0.06,0.94
36029014805,"Census Tract 148.05, Erie County, New York",2090,1980,110,0.05,0.95
36029014901,"Census Tract 149.01, Erie County, New York",2604,2431,173,0.07,0.93
36029014903,"Census Tract 149.03, Erie County, New York",5992,5694,298,0.05,0.95
36029015001,"Census Tract 150.01, Erie County, New York",5189,4935,254,0.05,0.95
36029015002,"Census Tract 150.02, Erie County, New York",3009,2773,236,0.08,0.92
36029015003,"Census Tract 150.03, Erie County, New York",3281,3084,197,0.06,0.94
36029015101,"Census Tract 151.01, Erie County, New York",3121,2969,152,0.05,0.95
36029015102,"Census Tract 151.02, Erie County, New York",2716,2580,136,0.05,0.95
36029015201,"Census Tract 152.01, Erie County, New York",3094,2927,167,0.05,0.95
36029015202,"Census Tract 152.02, Erie County, New York",4854,4598,256,0.05,0.95
36029015301,"Census Tract 153.01, Erie County, New York",4859,4537,322,0.07,0.93
36029015302,"Census Tract 153.02, Erie County, New York",2714,2534,180,0.07,0.93
36029015401,"Census Tract 154.01, Erie County, New York",2472,2268,204,0.08,0.92
36029015402,"Census Tract 154.02, Erie County, New York",4889,4533,356,0.07,0.93
36029015501,"Census Tract 155.01, Erie County, New York",2046,1822,224,0.11,0.89
36029015503,"Census Tract 155.03, Erie County, New York",2438,2225,213,0.09,0.91
36029015504,"Census Tract 155.04, Erie County, New York",3463,3203,260,0.08,0.92
36029015600,"Census Tract 156, Erie County, New York",1912,1667,245,0.13,0.87
36029015700,"Census Tract 157, Erie County, New York",3504,3222,282,0.08,0.92
36029015800,"Census Tract 158, Erie County, New York",4094,3954,140,0.03,0.97
36029015900,"Census Tract 159, Erie County, New York",4222,3922,300,0.07,0.93
36029016200,"Census Tract 162, Erie County, New York",2333,1997,336,0.14,0.86
36029016300,"Census Tract 163, Erie County, New York",2567,1496,1071,0.42,0.58
36029016400,"Census Tract 164, Erie County, New York",3062,1031,2031,0.66,0.34
36029016500,"Census Tract 165, Erie County, New York",2354,1303,1051,0.45,0.55
36029016600,"Census Tract 166, Erie County, New York",2887,119,2768,0.96,0.04
36029016700,"Census Tract 167, Erie County, New York",2641,1814,827,0.31,0.69
36029016801,"Census Tract 168.01, Erie County, New York",2065,181,1884,0.91,0.09
36029016802,"Census Tract 168.02, Erie County, New York",1713,126,1587,0.93,0.07
36029016900,"Census Tract 169, Erie County, New York",3519,2246,1273,0.36,0.64
36029017000,"Census Tract 170, Erie County, New York",2988,92,2896,0.97,0.03
36029017100,"Census Tract 171, Erie County, New York",5394,1706,3688,0.68,0.32
36029017200,"Census Tract 172, Erie County, New York",2263,1967,296,0.13,0.87
36029017301,"Census Tract 173.01, Erie County, New York",2973,2761,212,0.07,0.93
36029017302,"Census Tract 173.02, Erie County, New York",3957,3673,284,0.07,0.93
36029017400,"Census Tract 174, Erie County, New York",4636,2308,2328,0.5,0.5
36029017501,"Census Tract 175.01, Erie County, New York",1453,1204,249,0.17,0.83
36029017502,"Census Tract 175.02, Erie County, New York",2248,2109,139,0.06,0.94
36029940000,"Census Tract 9400, Erie County, New York",2135,525,1610,0.75,0.25
36029940100,"Census Tract 9401, Erie County, New York",20,5,15,0.75,0.25
36029980000,"Census Tract 9800, Erie County, New York",1599,319,1280,0.8,0.2
36029980300,"Census Tract 9803, Erie County, New York",2193,828,1365,0.62,0.38
36029980400,"Census Tract 9804, Erie County, New York",1110,380,730,0.66,0.34
36029980500,"Census Tract 9805, Erie County, New York",963,429,534,0.55,0.45
36029990000,"Census Tract 9900, Erie County, New York",0,0,0,0,0
36031960100,"Census Tract 9601, Essex County, New York",2476,2266,210,0.08,0.92
36031960200,"Census Tract 9602, Essex County, New York",2486,2272,214,0.09,0.91
36031960300,"Census Tract 9603, Essex County, New York",2585,2385,200,0.08,0.92
36031960401,"Census Tract 9604.01, Essex County, New York",1120,964,156,0.14,0.86
36031960402,"Census Tract 9604.02, Essex County, New York",1215,1044,171,0.14,0.86
36031960501,"Census Tract 9605.01, Essex County, New York",2473,2272,201,0.08,0.92
36031960502,"Census Tract 9605.02, Essex County, New York",2672,1965,707,0.26,0.74
36031960700,"Census Tract 9607, Essex County, New York",1914,1749,165,0.09,0.91
36031960800,"Census Tract 9608, Essex County, New York",1905,1807,98,0.05,0.95
36031960901,"Census Tract 9609.01, Essex County, New York",1519,1390,129,0.08,0.92
36031960902,"Census Tract 9609.02, Essex County, New York",2148,2000,148,0.07,0.93
36031961001,"Census Tract 9610.01, Essex County, New York",1512,1381,131,0.09,0.91
36031961002,"Census Tract 9610.02, Essex County, New York",3204,2854,350,0.11,0.89
36031961100,"Census Tract 9611, Essex County, New York",2042,1914,128,0.06,0.94
36031961201,"Census Tract 9612.01, Essex County, New York",1882,1765,117,0.06,0.94
36031961202,"Census Tract 9612.02, Essex County, New York",2907,2634,273,0.09,0.91
36031961300,"Census Tract 9613, Essex County, New York",1880,1711,169,0.09,0.91
36031961400,"Census Tract 9614, Essex County, New York",1441,1341,100,0.07,0.93
36033940000,"Census Tract 9400, Franklin County, New York",3663,129,3534,0.96,0.04
36033950200,"Census Tract 9502, Franklin County, New York",4542,3839,703,0.15,0.85
36033950301,"Census Tract 9503.01, Franklin County, New York",5147,4841,306,0.06,0.94
36033950501,"Census Tract 9505.01, Franklin County, New York",3168,2854,314,0.1,0.9
36033950502,"Census Tract 9505.02, Franklin County, New York",4551,2296,2255,0.5,0.5
36033950601,"Census Tract 9506.01, Franklin County, New York",1155,1097,58,0.05,0.95
36033950701,"Census Tract 9507.01, Franklin County, New York",1295,1180,115,0.09,0.91
36033950800,"Census Tract 9508, Franklin County, New York",2324,2101,223,0.1,0.9
36033950900,"Census Tract 9509, Franklin County, New York",3277,2983,294,0.09,0.91
36033951000,"Census Tract 9510, Franklin County, New York",1977,1791,186,0.09,0.91
36033951100,"Census Tract 9511, Franklin County, New York",3355,3112,243,0.07,0.93
36033951200,"Census Tract 9512, Franklin County, New York",1792,1698,94,0.05,0.95
36033951300,"Census Tract 9513, Franklin County, New York",1593,1506,87,0.05,0.95
36033951400,"Census Tract 9514, Franklin County, New York",4763,4416,347,0.07,0.93
36033952000,"Census Tract 9520, Franklin County, New York",4953,4716,237,0.05,0.95
36035970100,"Census Tract 9701, Fulton County, New York",2472,2288,184,0.07,0.93
36035970200,"Census Tract 9702, Fulton County, New York",2489,2309,180,0.07,0.93
36035970300,"Census Tract 9703, Fulton County, New York",3657,3283,374,0.1,0.9
36035970400,"Census Tract 9704, Fulton County, New York",1809,1692,117,0.06,0.94
36035970500,"Census Tract 9705, Fulton County, New York",3966,3692,274,0.07,0.93
36035970601,"Census Tract 9706.01, Fulton County, New York",3999,3306,693,0.17,0.83
36035970602,"Census Tract 9706.02, Fulton County, New York",2868,2595,273,0.1,0.9
36035970700,"Census Tract 9707, Fulton County, New York",3475,2909,566,0.16,0.84
36035970800,"Census Tract 9708, Fulton County, New York",2947,2500,447,0.15,0.85
36035970900,"Census Tract 9709, Fulton County, New York",3480,2919,561,0.16,0.84
36035971000,"Census Tract 9710, Fulton County, New York",2517,2122,395,0.16,0.84
36035971100,"Census Tract 9711, Fulton County, New York",2712,2232,480,0.18,0.82
36035971200,"Census Tract 9712, Fulton County, New York",3634,3246,388,0.11,0.89
36035971300,"Census Tract 9713, Fulton County, New York",4570,4038,532,0.12,0.88
36035971400,"Census Tract 9714, Fulton County, New York",3584,3194,390,0.11,0.89
36035971501,"Census Tract 9715.01, Fulton County, New York",2906,2674,232,0.08,0.92
36035971502,"Census Tract 9715.02, Fulton County, New York",2239,2052,187,0.08,0.92
36037940100,"Census Tract 9401, Genesee County, New York",241,19,222,0.92,0.08
36037950100,"Census Tract 9501, Genesee County, New York",5422,4769,653,0.12,0.88
36037950200,"Census Tract 9502, Genesee County, New York",5309,4550,759,0.14,0.86
36037950301,"Census Tract 9503.01, Genesee County, New York",2706,2570,136,0.05,0.95
36037950302,"Census Tract 9503.02, Genesee County, New York",3160,2912,248,0.08,0.92
36037950401,"Census Tract 9504.01, Genesee County, New York",3367,2759,608,0.18,0.82
36037950402,"Census Tract 9504.02, Genesee County, New York",2923,2698,225,0.08,0.92
36037950501,"Census Tract 9505.01, Genesee County, New York",1856,1574,282,0.15,0.85
36037950502,"Census Tract 9505.02, Genesee County, New York",1033,870,163,0.16,0.84
36037950600,"Census Tract 9506, Genesee County, New York",1918,1585,333,0.17,0.83
36037950700,"Census Tract 9507, Genesee County, New York",2438,1918,520,0.21,0.79
36037950800,"Census Tract 9508, Genesee County, New York",3237,2644,593,0.18,0.82
36037950900,"Census Tract 9509, Genesee County, New York",2386,2047,339,0.14,0.86
36037951000,"Census Tract 9510, Genesee County, New York",2732,1923,809,0.3,0.7
36037951100,"Census Tract 9511, Genesee County, New York",5378,4956,422,0.08,0.92
36037951200,"Census Tract 9512, Genesee County, New York",4711,4258,453,0.1,0.9
36037951300,"Census Tract 9513, Genesee County, New York",4070,3713,357,0.09,0.91
36037951400,"Census Tract 9514, Genesee County, New York",5501,5195,306,0.06,0.94
36039080100,"Census Tract 801, Greene County, New York",3226,2912,314,0.1,0.9
36039080201,"Census Tract 802.01, Greene County, New York",3741,3389,352,0.09,0.91
36039080202,"Census Tract 802.02, Greene County, New York",2627,2355,272,0.1,0.9
36039080301,"Census Tract 803.01, Greene County, New York",1708,1452,256,0.15,0.85
36039080302,"Census Tract 803.02, Greene County, New York",1456,1317,139,0.1,0.9
36039080402,"Census Tract 804.02, Greene County, New York",1898,1656,242,0.13,0.87
36039080403,"Census Tract 804.03, Greene County, New York",1034,869,165,0.16,0.84
36039080404,"Census Tract 804.04, Greene County, New York",2001,1775,226,0.11,0.89
36039080501,"Census Tract 805.01, Greene County, New York",2675,2356,319,0.12,0.88
36039080502,"Census Tract 805.02, Greene County, New York",3969,3404,565,0.14,0.86
36039080600,"Census Tract 806, Greene County, New York",3305,2863,442,0.13,0.87
36039080700,"Census Tract 807, Greene County, New York",2917,2479,438,0.15,0.85
36039080800,"Census Tract 808, Greene County, New York",2160,468,1692,0.78,0.22
36039080900,"Census Tract 809, Greene County, New York",3916,3367,549,0.14,0.86
36039081001,"Census Tract 810.01, Greene County, New York",1759,1307,452,0.26,0.74
36039081002,"Census Tract 810.02, Greene County, New York",2518,1707,811,0.32,0.68
36039081101,"Census Tract 811.01, Greene County, New York",4049,3412,637,0.16,0.84
36039081102,"Census Tract 811.02, Greene County, New York",2972,2406,566,0.19,0.81
36041950100,"Census Tract 9501, Hamilton County, New York",1146,1066,80,0.07,0.93
36041950300,"Census Tract 9503, Hamilton County, New York",1363,1266,97,0.07,0.93
36041950400,"Census Tract 9504, Hamilton County, New York",1317,1238,79,0.06,0.94
36041950500,"Census Tract 9505, Hamilton County, New York",1281,1199,82,0.06,0.94
36043010100,"Census Tract 101, Herkimer County, New York",5939,5559,380,0.06,0.94
36043010201,"Census Tract 102.01, Herkimer County, New York",3258,2954,304,0.09,0.91
36043010202,"Census Tract 102.02, Herkimer County, New York",3720,3508,212,0.06,0.94
36043010300,"Census Tract 103, Herkimer County, New York",5631,5021,610,0.11,0.89
36043010400,"Census Tract 104, Herkimer County, New York",2638,2270,368,0.14,0.86
36043010501,"Census Tract 105.01, Herkimer County, New York",2431,2229,202,0.08,0.92
36043010502,"Census Tract 105.02, Herkimer County, New York",1596,1447,149,0.09,0.91
36043010701,"Census Tract 107.01, Herkimer County, New York",2541,2239,302,0.12,0.88
36043010702,"Census Tract 107.02, Herkimer County, New York",2064,1821,243,0.12,0.88
36043010900,"Census Tract 109, Herkimer County, New York",3164,2974,190,0.06,0.94
36043011001,"Census Tract 110.01, Herkimer County, New York",1927,1766,161,0.08,0.92
36043011002,"Census Tract 110.02, Herkimer County, New York",2889,2703,186,0.06,0.94
36043011100,"Census Tract 111, Herkimer County, New York",2198,1908,290,0.13,0.87
36043011200,"Census Tract 112, Herkimer County, New York",5799,4852,947,0.16,0.84
36043011301,"Census Tract 113.01, Herkimer County, New York",1569,1473,96,0.06,0.94
36043011302,"Census Tract 113.02, Herkimer County, New York",3296,2998,298,0.09,0.91
36043011400,"Census Tract 114, Herkimer County, New York",4355,4136,219,0.05,0.95
36043011502,"Census Tract 115.02, Herkimer County, New York",2211,2078,133,0.06,0.94
36043011503,"Census Tract 115.03, Herkimer County, New York",1684,1598,86,0.05,0.95
36043011504,"Census Tract 115.04, Herkimer County, New York",1229,1119,110,0.09,0.91
36045060101,"Census Tract 601.01, Jefferson County, New York",2030,1896,134,0.07,0.93
36045060102,"Census Tract 601.02, Jefferson County, New York",1974,1821,153,0.08,0.92
36045060201,"Census Tract 602.01, Jefferson County, New York",1773,1642,131,0.07,0.93
36045060202,"Census Tract 602.02, Jefferson County, New York",2360,1699,661,0.28,0.72
36045060203,"Census Tract 602.03, Jefferson County, New York",2419,2259,160,0.07,0.93
36045060301,"Census Tract 603.01, Jefferson County, New York",1633,1525,108,0.07,0.93
36045060302,"Census Tract 603.02, Jefferson County, New York",2351,2178,173,0.07,0.93
36045060401,"Census Tract 604.01, Jefferson County, New York",3896,3590,306,0.08,0.92
36045060402,"Census Tract 604.02, Jefferson County, New York",2382,2097,285,0.12,0.88
36045060500,"Census Tract 605, Jefferson County, New York",5514,4630,884,0.16,0.84
36045060601,"Census Tract 606.01, Jefferson County, New York",3411,2908,503,0.15,0.85
36045060602,"Census Tract 606.02, Jefferson County, New York",3858,2214,1644,0.43,0.57
36045060700,"Census Tract 607, Jefferson County, New York",4204,3834,370,0.09,0.91
36045060803,"Census Tract 608.03, Jefferson County, New York",9418,5166,4252,0.45,0.55
36045060805,"Census Tract 608.05, Jefferson County, New York",4343,2461,1882,0.43,0.57
36045060806,"Census Tract 608.06, Jefferson County, New York",3359,1833,1526,0.45,0.55
36045060901,"Census Tract 609.01, Jefferson County, New York",3067,2511,556,0.18,0.82
36045060902,"Census Tract 609.02, Jefferson County, New York",2656,2299,357,0.13,0.87
36045061000,"Census Tract 610, Jefferson County, New York",3707,3135,572,0.15,0.85
36045061101,"Census Tract 611.01, Jefferson County, New York",2427,2088,339,0.14,0.86
36045061102,"Census Tract 611.02, Jefferson County, New York",2892,2297,595,0.21,0.79
36045061200,"Census Tract 612, Jefferson County, New York",3092,2193,899,0.29,0.71
36045061300,"Census Tract 613, Jefferson County, New York",3101,2396,705,0.23,0.77
36045061400,"Census Tract 614, Jefferson County, New York",3146,2565,581,0.18,0.82
36045061500,"Census Tract 615, Jefferson County, New York",4053,2840,1213,0.3,0.7
36045061600,"Census Tract 616, Jefferson County, New York",5175,4228,947,0.18,0.82
36045061700,"Census Tract 617, Jefferson County, New York",2117,1952,165,0.08,0.92
36045061801,"Census Tract 618.01, Jefferson County, New York",3531,3234,297,0.08,0.92
36045061802,"Census Tract 618.02, Jefferson County, New York",3406,3076,330,0.1,0.9
36045061900,"Census Tract 619, Jefferson County, New York",3560,3044,516,0.14,0.86
36045062100,"Census Tract 621, Jefferson County, New York",3818,2925,893,0.23,0.77
36045062200,"Census Tract 622, Jefferson County, New York",3915,3124,791,0.2,0.8
36045062400,"Census Tract 624, Jefferson County, New York",4630,3889,741,0.16,0.84
36045062500,"Census Tract 625, Jefferson County, New York",3305,3103,202,0.06,0.94
36045980000,"Census Tract 9800, Jefferson County, New York",198,103,95,0.48,0.52
36045990001,"Census Tract 9900.01, Jefferson County, New York",0,0,0,0,0
36047000100,"Census Tract 1, Kings County, New York",4616,3180,1436,0.31,0.69
36047000200,"Census Tract 2, Kings County, New York",1205,99,1106,0.92,0.08
36047000301,"Census Tract 3.01, Kings County, New York",3850,3127,723,0.19,0.81
36047000501,"Census Tract 5.01, Kings County, New York",4404,3329,1075,0.24,0.76
36047000502,"Census Tract 5.02, Kings County, New York",2640,2057,583,0.22,0.78
36047000700,"Census Tract 7, Kings County, New York",4415,3188,1227,0.28,0.72
36047000900,"Census Tract 9, Kings County, New York",5167,3565,1602,0.31,0.69
36047001100,"Census Tract 11, Kings County, New York",1578,772,806,0.51,0.49
36047001300,"Census Tract 13, Kings County, New York",2465,1171,1294,0.52,0.48
36047001501,"Census Tract 15.01, Kings County, New York",5161,1293,3868,0.75,0.25
36047001502,"Census Tract 15.02, Kings County, New York",5801,2335,3466,0.6,0.4
36047001801,"Census Tract 18.01, Kings County, New York",2563,898,1665,0.65,0.35
36047001802,"Census Tract 18.02, Kings County, New York",6,0,6,1,0
36047001803,"Census Tract 18.03, Kings County, New York",16,5,11,0.69,0.31
36047001804,"Census Tract 18.04, Kings County, New York",0,0,0,0,0
36047002000,"Census Tract 20, Kings County, New York",1694,140,1554,0.92,0.08
36047002100,"Census Tract 21, Kings County, New York",5975,4113,1862,0.31,0.69
36047002200,"Census Tract 22, Kings County, New York",4589,761,3828,0.83,0.17
36047002300,"Census Tract 23, Kings County, New York",3940,69,3871,0.98,0.02
36047002901,"Census Tract 29.01, Kings County, New York",3149,103,3046,0.97,0.03
36047003000,"Census Tract 30, Kings County, New York",1811,966,845,0.47,0.53
36047003101,"Census Tract 31.01, Kings County, New York",3395,1176,2219,0.65,0.35
36047003102,"Census Tract 31.02, Kings County, New York",0,0,0,0,0
36047003300,"Census Tract 33, Kings County, New York",4807,2258,2549,0.53,0.47
36047003400,"Census Tract 34, Kings County, New York",3489,2081,1408,0.4,0.6
36047003500,"Census Tract 35, Kings County, New York",2402,1066,1336,0.56,0.44
36047003600,"Census Tract 36, Kings County, New York",3959,2404,1555,0.39,0.61
36047003700,"Census Tract 37, Kings County, New York",4565,2240,2325,0.51,0.49
36047003800,"Census Tract 38, Kings County, New York",1529,1054,475,0.31,0.69
36047003900,"Census Tract 39, Kings County, New York",2644,1419,1225,0.46,0.54
36047004100,"Census Tract 41, Kings County, New York",3398,2184,1214,0.36,0.64
36047004300,"Census Tract 43, Kings County, New York",3810,2428,1382,0.36,0.64
36047004400,"Census Tract 44, Kings County, New York",2448,1938,510,0.21,0.79
36047004500,"Census Tract 45, Kings County, New York",3476,2674,802,0.23,0.77
36047004600,"Census Tract 46, Kings County, New York",1154,892,262,0.23,0.77
36047004700,"Census Tract 47, Kings County, New York",1951,1143,808,0.41,0.59
36047004900,"Census Tract 49, Kings County, New York",2412,1604,808,0.33,0.67
36047005000,"Census Tract 50, Kings County, New York",2535,1915,620,0.24,0.76
36047005100,"Census Tract 51, Kings County, New York",2658,1754,904,0.34,0.66
36047005201,"Census Tract 52.01, Kings County, New York",1879,1350,529,0.28,0.72
36047005202,"Census Tract 52.02, Kings County, New York",2668,2068,600,0.22,0.78
36047005301,"Census Tract 53.01, Kings County, New York",2164,1256,908,0.42,0.58
36047005302,"Census Tract 53.02, Kings County, New York",86,56,30,0.35,0.65
36047005303,"Census Tract 53.03, Kings County, New York",0,0,0,0,0
36047005400,"Census Tract 54, Kings County, New York",3426,2347,1079,0.31,0.69
36047005601,"Census Tract 56.01, Kings County, New York",2692,1907,785,0.29,0.71
36047005602,"Census Tract 56.02, Kings County, New York",1734,1264,470,0.27,0.73
36047005800,"Census Tract 58, Kings County, New York",3450,2236,1214,0.35,0.65
36047005900,"Census Tract 59, Kings County, New York",1742,821,921,0.53,0.47
36047006000,"Census Tract 60, Kings County, New York",2876,1572,1304,0.45,0.55
36047006200,"Census Tract 62, Kings County, New York",2958,1851,1107,0.37,0.63
36047006300,"Census Tract 63, Kings County, New York",2007,1483,524,0.26,0.74
36047006400,"Census Tract 64, Kings County, New York",3623,2254,1369,0.38,0.62
36047006500,"Census Tract 65, Kings County, New York",5461,4267,1194,0.22,0.78
36047006600,"Census Tract 66, Kings County, New York",3974,2237,1737,0.44,0.56
36047006700,"Census Tract 67, Kings County, New York",3618,2860,758,0.21,0.79
36047006800,"Census Tract 68, Kings County, New York",5491,2607,2884,0.53,0.47
36047006901,"Census Tract 69.01, Kings County, New York",1631,1189,442,0.27,0.73
36047006902,"Census Tract 69.02, Kings County, New York",1962,1367,595,0.3,0.7
36047007000,"Census Tract 70, Kings County, New York",2454,1290,1164,0.47,0.53
36047007100,"Census Tract 71, Kings County, New York",4362,887,3475,0.8,0.2
36047007200,"Census Tract 72, Kings County, New York",2082,264,1818,0.87,0.13
36047007400,"Census Tract 74, Kings County, New York",5829,411,5418,0.93,0.07
36047007500,"Census Tract 75, Kings County, New York",4691,3483,1208,0.26,0.74
36047007600,"Census Tract 76, Kings County, New York",4872,553,4319,0.89,0.11
36047007700,"Census Tract 77, Kings County, New York",5690,4111,1579,0.28,0.72
36047007800,"Census Tract 78, Kings County, New York",5333,524,4809,0.9,0.1
36047008000,"Census Tract 80, Kings County, New York",4024,453,3571,0.89,0.11
36047008200,"Census Tract 82, Kings County, New York",4008,634,3374,0.84,0.16
36047008400,"Census Tract 84, Kings County, New York",3311,624,2687,0.81,0.19
36047008500,"Census Tract 85, Kings County, New York",6673,109,6564,0.98,0.02
36047008600,"Census Tract 86, Kings County, New York",0,0,0,0,0
36047008800,"Census Tract 88, Kings County, New York",3258,800,2458,0.75,0.25
36047009001,"Census Tract 90.01, Kings County, New York",1886,216,1670,0.89,0.11
36047009002,"Census Tract 90.02, Kings County, New York",1391,115,1276,0.92,0.08
36047009201,"Census Tract 92.01, Kings County, New York",2087,301,1786,0.86,0.14
36047009202,"Census Tract 92.02, Kings County, New York",3424,303,3121,0.91,0.09
36047009401,"Census Tract 94.01, Kings County, New York",3127,152,2975,0.95,0.05
36047009402,"Census Tract 94.02, Kings County, New York",3168,621,2547,0.8,0.2
36047009600,"Census Tract 96, Kings County, New York",6462,804,5658,0.88,0.12
36047009800,"Census Tract 98, Kings County, New York",7440,298,7142,0.96,0.04
36047010000,"Census Tract 100, Kings County, New York",7741,434,7307,0.94,0.06
36047010100,"Census Tract 101, Kings County, New York",4590,1430,3160,0.69,0.31
36047010200,"Census Tract 102, Kings County, New York",6578,297,6281,0.95,0.05
36047010401,"Census Tract 104.01, Kings County, New York",3015,156,2859,0.95,0.05
36047010402,"Census Tract 104.02, Kings County, New York",2965,247,2718,0.92,0.08
36047010601,"Census Tract 106.01, Kings County, New York",3037,134,2903,0.96,0.04
36047010602,"Census Tract 106.02, Kings County, New York",2820,77,2743,0.97,0.03
36047010801,"Census Tract 108.01, Kings County, New York",2876,84,2792,0.97,0.03
36047010802,"Census Tract 108.02, Kings County, New York",2840,240,2600,0.92,0.08
36047011000,"Census Tract 110, Kings County, New York",2709,648,2061,0.76,0.24
36047011200,"Census Tract 112, Kings County, New York",6636,2283,4353,0.66,0.34
36047011400,"Census Tract 114, Kings County, New York",4150,1947,2203,0.53,0.47
36047011600,"Census Tract 116, Kings County, New York",5529,478,5051,0.91,0.09
36047011700,"Census Tract 117, Kings County, New York",2672,1425,1247,0.47,0.53
36047011800,"Census Tract 118, Kings County, New York",2578,203,2375,0.92,0.08
36047011901,"Census Tract 119.01, Kings County, New York",1589,879,710,0.45,0.55
36047011902,"Census Tract 119.02, Kings County, New York",0,0,0,0,0
36047012000,"Census Tract 120, Kings County, New York",1176,93,1083,0.92,0.08
36047012100,"Census Tract 121, Kings County, New York",1916,1046,870,0.45,0.55
36047012200,"Census Tract 122, Kings County, New York",5521,630,4891,0.89,0.11
36047012600,"Census Tract 126, Kings County, New York",3085,1053,2032,0.66,0.34
36047012700,"Census Tract 127, Kings County, New York",4036,1117,2919,0.72,0.28
36047012801,"Census Tract 128.01, Kings County, New York",2567,494,2073,0.81,0.19
36047012901,"Census Tract 129.01, Kings County, New York",2333,1266,1067,0.46,0.54
36047012902,"Census Tract 129.02, Kings County, New York",3318,1681,1637,0.49,0.51
36047013000,"Census Tract 130, Kings County, New York",5347,2661,2686,0.5,0.5
36047013100,"Census Tract 131, Kings County, New York",3979,2263,1716,0.43,0.57
36047013200,"Census Tract 132, Kings County, New York",2870,746,2124,0.74,0.26
36047013300,"Census Tract 133, Kings County, New York",4411,2919,1492,0.34,0.66
36047013400,"Census Tract 134, Kings County, New York",4212,2168,2044,0.49,0.51
36047013500,"Census Tract 135, Kings County, New York",3799,2447,1352,0.36,0.64
36047013600,"Census Tract 136, Kings County, New York",4079,2446,1633,0.4,0.6
36047013700,"Census Tract 137, Kings County, New York",3406,2176,1230,0.36,0.64
36047013800,"Census Tract 138, Kings County, New York",3247,1937,1310,0.4,0.6
36047013900,"Census Tract 139, Kings County, New York",3727,2280,1447,0.39,0.61
36047014000,"Census Tract 140, Kings County, New York",2136,1418,718,0.34,0.66
36047014101,"Census Tract 141.01, Kings County, New York",1621,829,792,0.49,0.51
36047014102,"Census Tract 141.02, Kings County, New York",1858,1088,770,0.41,0.59
36047014200,"Census Tract 142, Kings County, New York",3434,1988,1446,0.42,0.58
36047014300,"Census Tract 143, Kings County, New York",3705,1903,1802,0.49,0.51
36047014500,"Census Tract 145, Kings County, New York",4404,2087,2317,0.53,0.47
36047014700,"Census Tract 147, Kings County, New York",2242,1287,955,0.43,0.57
36047014800,"Census Tract 148, Kings County, New York",1244,907,337,0.27,0.73
36047014901,"Census Tract 149.01, Kings County, New York",1529,1002,527,0.34,0.66
36047014902,"Census Tract 149.02, Kings County, New York",3601,2260,1341,0.37,0.63
36047015000,"Census Tract 150, Kings County, New York",1791,1045,746,0.42,0.58
36047015100,"Census Tract 151, Kings County, New York",3696,2713,983,0.27,0.73
36047015200,"Census Tract 152, Kings County, New York",2545,1481,1064,0.42,0.58
36047015300,"Census Tract 153, Kings County, New York",2633,1976,657,0.25,0.75
36047015400,"Census Tract 154, Kings County, New York",9,3,6,0.67,0.33
36047015500,"Census Tract 155, Kings County, New York",3466,2625,841,0.24,0.76
36047015700,"Census Tract 157, Kings County, New York",4447,3339,1108,0.25,0.75
36047015900,"Census Tract 159, Kings County, New York",5206,3802,1404,0.27,0.73
36047016000,"Census Tract 160, Kings County, New York",4462,2154,2308,0.52,0.48
36047016100,"Census Tract 161, Kings County, New York",3450,2051,1399,0.41,0.59
36047016200,"Census Tract 162, Kings County, New York",2218,1296,922,0.42,0.58
36047016300,"Census Tract 163, Kings County, New York",4088,2312,1776,0.43,0.57
36047016400,"Census Tract 164, Kings County, New York",775,319,456,0.59,0.41
36047016500,"Census Tract 165, Kings County, New York",5080,3825,1255,0.25,0.75
36047016600,"Census Tract 166, Kings County, New York",1968,1548,420,0.21,0.79
36047016700,"Census Tract 167, Kings County, New York",4754,3525,1229,0.26,0.74
36047016800,"Census Tract 168, Kings County, New York",1695,1016,679,0.4,0.6
36047016900,"Census Tract 169, Kings County, New York",4459,2694,1765,0.4,0.6
36047017000,"Census Tract 170, Kings County, New York",3604,1587,2017,0.56,0.44
36047017100,"Census Tract 171, Kings County, New York",3717,2822,895,0.24,0.76
36047017200,"Census Tract 172, Kings County, New York",3300,1237,2063,0.63,0.37
36047017400,"Census Tract 174, Kings County, New York",1950,938,1012,0.52,0.48
36047017500,"Census Tract 175, Kings County, New York",5,0,5,1,0
36047017600,"Census Tract 176, Kings County, New York",2418,970,1448,0.6,0.4
36047017700,"Census Tract 177, Kings County, New York",15,2,13,0.87,0.13
36047017800,"Census Tract 178, Kings County, New York",2959,966,1993,0.67,0.33
36047017900,"Census Tract 179, Kings County, New York",3895,954,2941,0.76,0.24
36047018000,"Census Tract 180, Kings County, New York",3125,1033,2092,0.67,0.33
36047018100,"Census Tract 181, Kings County, New York",4204,2477,1727,0.41,0.59
36047018200,"Census Tract 182, Kings County, New York",3745,924,2821,0.75,0.25
36047018300,"Census Tract 183, Kings County, New York",2784,1630,1154,0.41,0.59
36047018400,"Census Tract 184, Kings County, New York",2460,895,1565,0.64,0.36
36047018501,"Census Tract 185.01, Kings County, New York",4461,316,4145,0.93,0.07
36047018600,"Census Tract 186, Kings County, New York",2364,809,1555,0.66,0.34
36047018700,"Census Tract 187, Kings County, New York",1336,667,669,0.5,0.5
36047018800,"Census Tract 188, Kings County, New York",2955,1121,1834,0.62,0.38
36047019000,"Census Tract 190, Kings County, New York",4853,1262,3591,0.74,0.26
36047019100,"Census Tract 191, Kings County, New York",3427,1634,1793,0.52,0.48
36047019200,"Census Tract 192, Kings County, New York",3541,1492,2049,0.58,0.42
36047019300,"Census Tract 193, Kings County, New York",6279,1942,4337,0.69,0.31
36047019400,"Census Tract 194, Kings County, New York",3570,681,2889,0.81,0.19
36047019500,"Census Tract 195, Kings County, New York",3684,1773,1911,0.52,0.48
36047019600,"Census Tract 196, Kings County, New York",4691,1541,3150,0.67,0.33
36047019700,"Census Tract 197, Kings County, New York",3585,1879,1706,0.48,0.52
36047019800,"Census Tract 198, Kings County, New York",2061,900,1161,0.56,0.44
36047019900,"Census Tract 199, Kings County, New York",3978,1838,2140,0.54,0.46
36047020000,"Census Tract 200, Kings County, New York",2442,1005,1437,0.59,0.41
36047020100,"Census Tract 201, Kings County, New York",3862,2037,1825,0.47,0.53
36047020200,"Census Tract 202, Kings County, New York",2147,1062,1085,0.51,0.49
36047020300,"Census Tract 203, Kings County, New York",2132,1070,1062,0.5,0.5
36047020400,"Census Tract 204, Kings County, New York",2040,1115,925,0.45,0.55
36047020500,"Census Tract 205, Kings County, New York",3405,1942,1463,0.43,0.57
36047020600,"Census Tract 206, Kings County, New York",2505,1214,1291,0.52,0.48
36047020700,"Census Tract 207, Kings County, New York",4871,2745,2126,0.44,0.56
36047020800,"Census Tract 208, Kings County, New York",3782,1111,2671,0.71,0.29
36047021000,"Census Tract 210, Kings County, New York",4488,1130,3358,0.75,0.25
36047021100,"Census Tract 211, Kings County, New York",2505,708,1797,0.72,0.28
36047021200,"Census Tract 212, Kings County, New York",5278,950,4328,0.82,0.18
36047021300,"Census Tract 213, Kings County, New York",3880,857,3023,0.78,0.22
36047021400,"Census Tract 214, Kings County, New York",2502,1017,1485,0.59,0.41
36047021500,"Census Tract 215, Kings County, New York",5569,2552,3017,0.54,0.46
36047021600,"Census Tract 216, Kings County, New York",4280,3141,1139,0.27,0.73
36047021700,"Census Tract 217, Kings County, New York",4351,1377,2974,0.68,0.32
36047021800,"Census Tract 218, Kings County, New York",4191,3162,1029,0.25,0.75
36047021900,"Census Tract 219, Kings County, New York",4225,1594,2631,0.62,0.38
36047022000,"Census Tract 220, Kings County, New York",5660,4419,1241,0.22,0.78
36047022100,"Census Tract 221, Kings County, New York",3897,1321,2576,0.66,0.34
36047022200,"Census Tract 222, Kings County, New York",5633,4407,1226,0.22,0.78
36047022400,"Census Tract 224, Kings County, New York",6117,4282,1835,0.3,0.7
36047022600,"Census Tract 226, Kings County, New York",2664,984,1680,0.63,0.37
36047022700,"Census Tract 227, Kings County, New York",4515,1446,3069,0.68,0.32
36047022800,"Census Tract 228, Kings County, New York",3638,2008,1630,0.45,0.55
36047022900,"Census Tract 229, Kings County, New York",3923,1629,2294,0.58,0.42
36047023000,"Census Tract 230, Kings County, New York",4442,2948,1494,0.34,0.66
36047023100,"Census Tract 231, Kings County, New York",3832,1742,2090,0.55,0.45
36047023200,"Census Tract 232, Kings County, New York",6382,5038,1344,0.21,0.79
36047023300,"Census Tract 233, Kings County, New York",5961,1720,4241,0.71,0.29
36047023400,"Census Tract 234, Kings County, New York",5923,5299,624,0.11,0.89
36047023500,"Census Tract 235, Kings County, New York",5921,3948,1973,0.33,0.67
36047023600,"Census Tract 236, Kings County, New York",6548,5712,836,0.13,0.87
36047023800,"Census Tract 238, Kings County, New York",5414,4624,790,0.15,0.85
36047024000,"Census Tract 240, Kings County, New York",5165,4348,817,0.16,0.84
36047024100,"Census Tract 241, Kings County, New York",3175,1702,1473,0.46,0.54
36047024200,"Census Tract 242, Kings County, New York",3289,2401,888,0.27,0.73
36047024300,"Census Tract 243, Kings County, New York",4347,1532,2815,0.65,0.35
36047024400,"Census Tract 244, Kings County, New York",3651,2540,1111,0.3,0.7
36047024500,"Census Tract 245, Kings County, New York",4257,1218,3039,0.71,0.29
36047024600,"Census Tract 246, Kings County, New York",3436,1924,1512,0.44,0.56
36047024700,"Census Tract 247, Kings County, New York",2820,644,2176,0.77,0.23
36047024800,"Census Tract 248, Kings County, New York",2647,1093,1554,0.59,0.41
36047024900,"Census Tract 249, Kings County, New York",4264,1259,3005,0.7,0.3
36047025000,"Census Tract 250, Kings County, New York",1748,264,1484,0.85,0.15
36047025100,"Census Tract 251, Kings County, New York",4209,771,3438,0.82,0.18
36047025200,"Census Tract 252, Kings County, New York",5300,1882,3418,0.64,0.36
36047025300,"Census Tract 253, Kings County, New York",3517,1296,2221,0.63,0.37
36047025400,"Census Tract 254, Kings County, New York",3650,1055,2595,0.71,0.29
36047025500,"Census Tract 255, Kings County, New York",4799,58,4741,0.99,0.01
36047025600,"Census Tract 256, Kings County, New York",3366,958,2408,0.72,0.28
36047025700,"Census Tract 257, Kings County, New York",2822,1227,1595,0.57,0.43
36047025800,"Census Tract 258, Kings County, New York",5073,1843,3230,0.64,0.36
36047025901,"Census Tract 259.01, Kings County, New York",2328,773,1555,0.67,0.33
36047025902,"Census Tract 259.02, Kings County, New York",3560,52,3508,0.99,0.01
36047026000,"Census Tract 260, Kings County, New York",3656,1066,2590,0.71,0.29
36047026100,"Census Tract 261, Kings County, New York",6479,1787,4692,0.72,0.28
36047026200,"Census Tract 262, Kings County, New York",2726,623,2103,0.77,0.23
36047026300,"Census Tract 263, Kings County, New York",2088,454,1634,0.78,0.22
36047026400,"Census Tract 264, Kings County, New York",5103,1494,3609,0.71,0.29
36047026500,"Census Tract 265, Kings County, New York",4385,994,3391,0.77,0.23
36047026600,"Census Tract 266, Kings County, New York",3961,1201,2760,0.7,0.3
36047026700,"Census Tract 267, Kings County, New York",4228,1197,3031,0.72,0.28
36047026800,"Census Tract 268, Kings County, New York",4686,1779,2907,0.62,0.38
36047026900,"Census Tract 269, Kings County, New York",3005,689,2316,0.77,0.23
36047027000,"Census Tract 270, Kings County, New York",2719,1309,1410,0.52,0.48
36047027100,"Census Tract 271, Kings County, New York",3493,488,3005,0.86,0.14
36047027200,"Census Tract 272, Kings County, New York",3633,1363,2270,0.62,0.38
36047027300,"Census Tract 273, Kings County, New York",3131,574,2557,0.82,0.18
36047027400,"Census Tract 274, Kings County, New York",3272,1172,2100,0.64,0.36
36047027500,"Census Tract 275, Kings County, New York",4071,1107,2964,0.73,0.27
36047027600,"Census Tract 276, Kings County, New York",3886,1140,2746,0.71,0.29
36047027700,"Census Tract 277, Kings County, New York",4351,543,3808,0.88,0.12
36047027800,"Census Tract 278, Kings County, New York",3542,1459,2083,0.59,0.41
36047027900,"Census Tract 279, Kings County, New York",3674,714,2960,0.81,0.19
36047028000,"Census Tract 280, Kings County, New York",1862,584,1278,0.69,0.31
36047028100,"Census Tract 281, Kings County, New York",4800,718,4082,0.85,0.15
36047028200,"Census Tract 282, Kings County, New York",3282,1452,1830,0.56,0.44
36047028300,"Census Tract 283, Kings County, New York",3933,474,3459,0.88,0.12
36047028400,"Census Tract 284, Kings County, New York",4396,1706,2690,0.61,0.39
36047028501,"Census Tract 285.01, Kings County, New York",636,202,434,0.68,0.32
36047028502,"Census Tract 285.02, Kings County, New York",2658,13,2645,1,0
36047028600,"Census Tract 286, Kings County, New York",6094,2358,3736,0.61,0.39
36047028700,"Census Tract 287, Kings County, New York",3103,603,2500,0.81,0.19
36047028800,"Census Tract 288, Kings County, New York",3900,1486,2414,0.62,0.38
36047028900,"Census Tract 289, Kings County, New York",3933,764,3169,0.81,0.19
36047029000,"Census Tract 290, Kings County, New York",4377,2103,2274,0.52,0.48
36047029100,"Census Tract 291, Kings County, New York",3042,641,2401,0.79,0.21
36047029200,"Census Tract 292, Kings County, New York",2781,1086,1695,0.61,0.39
36047029300,"Census Tract 293, Kings County, New York",3402,530,2872,0.84,0.16
36047029400,"Census Tract 294, Kings County, New York",2298,1180,1118,0.49,0.51
36047029500,"Census Tract 295, Kings County, New York",3851,932,2919,0.76,0.24
36047029600,"Census Tract 296, Kings County, New York",5993,2936,3057,0.51,0.49
36047029700,"Census Tract 297, Kings County, New York",3921,693,3228,0.82,0.18
36047029800,"Census Tract 298, Kings County, New York",3955,1446,2509,0.63,0.37
36047029900,"Census Tract 299, Kings County, New York",2496,270,2226,0.89,0.11
36047030000,"Census Tract 300, Kings County, New York",4224,1192,3032,0.72,0.28
36047030100,"Census Tract 301, Kings County, New York",2970,287,2683,0.9,0.1
36047030200,"Census Tract 302, Kings County, New York",4391,1324,3067,0.7,0.3
36047030300,"Census Tract 303, Kings County, New York",4952,158,4794,0.97,0.03
36047030400,"Census Tract 304, Kings County, New York",4686,1627,3059,0.65,0.35
36047030500,"Census Tract 305, Kings County, New York",7249,2916,4333,0.6,0.4
36047030600,"Census Tract 306, Kings County, New York",2215,695,1520,0.69,0.31
36047030700,"Census Tract 307, Kings County, New York",5625,302,5323,0.95,0.05
36047030800,"Census Tract 308, Kings County, New York",2314,1137,1177,0.51,0.49
36047030900,"Census Tract 309, Kings County, New York",2209,168,2041,0.92,0.08
36047031100,"Census Tract 311, Kings County, New York",3191,590,2601,0.82,0.18
36047031300,"Census Tract 313, Kings County, New York",5109,966,4143,0.81,0.19
36047031401,"Census Tract 314.01, Kings County, New York",5142,2819,2323,0.45,0.55
36047031402,"Census Tract 314.02, Kings County, New York",0,0,0,0,0
36047031500,"Census Tract 315, Kings County, New York",5613,1881,3732,0.66,0.34
36047031701,"Census Tract 317.01, Kings County, New York",3999,1289,2710,0.68,0.32
36047031702,"Census Tract 317.02, Kings County, New York",3714,1400,2314,0.62,0.38
36047031900,"Census Tract 319, Kings County, New York",3452,1153,2299,0.67,0.33
36047032100,"Census Tract 321, Kings County, New York",5488,979,4509,0.82,0.18
36047032300,"Census Tract 323, Kings County, New York",3509,686,2823,0.8,0.2
36047032500,"Census Tract 325, Kings County, New York",6218,799,5419,0.87,0.13
36047032600,"Census Tract 326, Kings County, New York",7075,883,6192,0.88,0.12
36047032700,"Census Tract 327, Kings County, New York",3074,805,2269,0.74,0.26
36047032800,"Census Tract 328, Kings County, New York",3090,288,2802,0.91,0.09
36047032900,"Census Tract 329, Kings County, New York",5707,1848,3859,0.68,0.32
36047033000,"Census Tract 330, Kings County, New York",4423,775,3648,0.82,0.18
36047033100,"Census Tract 331, Kings County, New York",4217,2476,1741,0.41,0.59
36047033300,"Census Tract 333, Kings County, New York",4503,3002,1501,0.33,0.67
36047033500,"Census Tract 335, Kings County, New York",3231,1840,1391,0.43,0.57
36047033600,"Census Tract 336, Kings County, New York",4765,3480,1285,0.27,0.73
36047033701,"Census Tract 337.01, Kings County, New York",2510,1088,1422,0.57,0.43
36047033702,"Census Tract 337.02, Kings County, New York",2116,1152,964,0.46,0.54
36047033900,"Census Tract 339, Kings County, New York",4676,1102,3574,0.76,0.24
36047034000,"Census Tract 340, Kings County, New York",1958,614,1344,0.69,0.31
36047034100,"Census Tract 341, Kings County, New York",2685,638,2047,0.76,0.24
36047034200,"Census Tract 342, Kings County, New York",7060,1933,5127,0.73,0.27
36047034300,"Census Tract 343, Kings County, New York",5024,446,4578,0.91,0.09
36047034500,"Census Tract 345, Kings County, New York",2738,374,2364,0.86,0.14
36047034700,"Census Tract 347, Kings County, New York",3645,257,3388,0.93,0.07
36047034800,"Census Tract 348, Kings County, New York",2828,664,2164,0.77,0.23
36047034901,"Census Tract 349.01, Kings County, New York",2067,99,1968,0.95,0.05
36047034902,"Census Tract 349.02, Kings County, New York",3347,322,3025,0.9,0.1
36047035000,"Census Tract 350, Kings County, New York",3082,2932,150,0.05,0.95
36047035101,"Census Tract 351.01, Kings County, New York",2243,244,1999,0.89,0.11
36047035102,"Census Tract 351.02, Kings County, New York",2626,884,1742,0.66,0.34
36047035200,"Census Tract 352, Kings County, New York",1367,637,730,0.53,0.47
36047035301,"Census Tract 353.01, Kings County, New York",2566,389,2177,0.85,0.15
36047035302,"Census Tract 353.02, Kings County, New York",2811,932,1879,0.67,0.33
36047035400,"Census Tract 354, Kings County, New York",5493,5073,420,0.08,0.92
36047035500,"Census Tract 355, Kings County, New York",5192,1029,4163,0.8,0.2
36047035601,"Census Tract 356.01, Kings County, New York",2902,2650,252,0.09,0.91
36047035602,"Census Tract 356.02, Kings County, New York",5474,4882,592,0.11,0.89
36047035701,"Census Tract 357.01, Kings County, New York",2322,80,2242,0.97,0.03
36047035702,"Census Tract 357.02, Kings County, New York",15,3,12,0.8,0.2
36047035900,"Census Tract 359, Kings County, New York",5617,253,5364,0.95,0.05
36047036001,"Census Tract 360.01, Kings County, New York",3387,2882,505,0.15,0.85
36047036002,"Census Tract 360.02, Kings County, New York",4203,3431,772,0.18,0.82
36047036100,"Census Tract 361, Kings County, New York",2964,137,2827,0.95,0.05
36047036200,"Census Tract 362, Kings County, New York",4140,1721,2419,0.58,0.42
36047036300,"Census Tract 363, Kings County, New York",5385,124,5261,0.98,0.02
36047036400,"Census Tract 364, Kings County, New York",3006,1383,1623,0.54,0.46
36047036501,"Census Tract 365.01, Kings County, New York",2959,94,2865,0.97,0.03
36047036502,"Census Tract 365.02, Kings County, New York",1902,113,1789,0.94,0.06
36047036600,"Census Tract 366, Kings County, New York",4681,1889,2792,0.6,0.4
36047036700,"Census Tract 367, Kings County, New York",1796,107,1689,0.94,0.06
36047036900,"Census Tract 369, Kings County, New York",6136,672,5464,0.89,0.11
36047037000,"Census Tract 370, Kings County, New York",4750,2881,1869,0.39,0.61
36047037100,"Census Tract 371, Kings County, New York",4503,403,4100,0.91,0.09
36047037300,"Census Tract 373, Kings County, New York",4385,502,3883,0.89,0.11
36047037401,"Census Tract 374.01, Kings County, New York",4696,3105,1591,0.34,0.66
36047037402,"Census Tract 374.02, Kings County, New York",5367,3214,2153,0.4,0.6
36047037500,"Census Tract 375, Kings County, New York",3809,772,3037,0.8,0.2
36047037700,"Census Tract 377, Kings County, New York",3970,783,3187,0.8,0.2
36047037900,"Census Tract 379, Kings County, New York",3851,435,3416,0.89,0.11
36047038100,"Census Tract 381, Kings County, New York",5313,660,4653,0.88,0.12
36047038200,"Census Tract 382, Kings County, New York",5882,336,5546,0.94,0.06
36047038300,"Census Tract 383, Kings County, New York",4338,866,3472,0.8,0.2
36047038500,"Census Tract 385, Kings County, New York",3969,793,3176,0.8,0.2
36047038600,"Census Tract 386, Kings County, New York",3812,1383,2429,0.64,0.36
36047038700,"Census Tract 387, Kings County, New York",4908,1012,3896,0.79,0.21
36047038800,"Census Tract 388, Kings County, New York",4047,2714,1333,0.33,0.67
36047038900,"Census Tract 389, Kings County, New York",3570,1041,2529,0.71,0.29
36047039000,"Census Tract 390, Kings County, New York",2321,1960,361,0.16,0.84
36047039100,"Census Tract 391, Kings County, New York",5776,2003,3773,0.65,0.35
36047039200,"Census Tract 392, Kings County, New York",2908,2214,694,0.24,0.76
36047039300,"Census Tract 393, Kings County, New York",4141,1251,2890,0.7,0.3
36047039400,"Census Tract 394, Kings County, New York",2187,1738,449,0.21,0.79
36047039500,"Census Tract 395, Kings County, New York",4030,1136,2894,0.72,0.28
36047039600,"Census Tract 396, Kings County, New York",1948,1580,368,0.19,0.81
36047039700,"Census Tract 397, Kings County, New York",3868,950,2918,0.75,0.25
36047039800,"Census Tract 398, Kings County, New York",2841,957,1884,0.66,0.34
36047039900,"Census Tract 399, Kings County, New York",4378,837,3541,0.81,0.19
36047040000,"Census Tract 400, Kings County, New York",3281,1235,2046,0.62,0.38
36047040100,"Census Tract 401, Kings County, New York",3778,781,2997,0.79,0.21
36047040200,"Census Tract 402, Kings County, New York",3025,735,2290,0.76,0.24
36047040300,"Census Tract 403, Kings County, New York",3892,727,3165,0.81,0.19
36047040400,"Census Tract 404, Kings County, New York",2812,885,1927,0.69,0.31
36047040500,"Census Tract 405, Kings County, New York",1829,298,1531,0.84,0.16
36047040600,"Census Tract 406, Kings County, New York",3599,1044,2555,0.71,0.29
36047040700,"Census Tract 407, Kings County, New York",6,1,5,0.83,0.17
36047040800,"Census Tract 408, Kings County, New York",3933,924,3009,0.77,0.23
36047040900,"Census Tract 409, Kings County, New York",3800,617,3183,0.84,0.16
36047041000,"Census Tract 410, Kings County, New York",2136,1055,1081,0.51,0.49
36047041100,"Census Tract 411, Kings County, New York",3332,571,2761,0.83,0.17
36047041200,"Census Tract 412, Kings County, New York",3375,1354,2021,0.6,0.4
36047041300,"Census Tract 413, Kings County, New York",3951,672,3279,0.83,0.17
36047041401,"Census Tract 414.01, Kings County, New York",1480,1106,374,0.25,0.75
36047041402,"Census Tract 414.02, Kings County, New York",1855,1480,375,0.2,0.8
36047041500,"Census Tract 415, Kings County, New York",4032,697,3335,0.83,0.17
36047041600,"Census Tract 416, Kings County, New York",2112,1720,392,0.19,0.81
36047041700,"Census Tract 417, Kings County, New York",3348,352,2996,0.89,0.11
36047041800,"Census Tract 418, Kings County, New York",2645,1921,724,0.27,0.73
36047041900,"Census Tract 419, Kings County, New York",3880,601,3279,0.85,0.15
36047042000,"Census Tract 420, Kings County, New York",1912,1516,396,0.21,0.79
36047042100,"Census Tract 421, Kings County, New York",4866,1238,3628,0.75,0.25
36047042200,"Census Tract 422, Kings County, New York",3663,2408,1255,0.34,0.66
36047042300,"Census Tract 423, Kings County, New York",4566,1291,3275,0.72,0.28
36047042400,"Census Tract 424, Kings County, New York",4175,1588,2587,0.62,0.38
36047042500,"Census Tract 425, Kings County, New York",3026,845,2181,0.72,0.28
36047042600,"Census Tract 426, Kings County, New York",4350,1531,2819,0.65,0.35
36047042700,"Census Tract 427, Kings County, New York",4920,1523,3397,0.69,0.31
36047042800,"Census Tract 428, Kings County, New York",4290,2275,2015,0.47,0.53
36047042900,"Census Tract 429, Kings County, New York",5556,1498,4058,0.73,0.27
36047043000,"Census Tract 430, Kings County, New York",3842,1583,2259,0.59,0.41
36047043100,"Census Tract 431, Kings County, New York",4884,1449,3435,0.7,0.3
36047043200,"Census Tract 432, Kings County, New York",4514,1391,3123,0.69,0.31
36047043300,"Census Tract 433, Kings County, New York",3843,584,3259,0.85,0.15
36047043400,"Census Tract 434, Kings County, New York",3866,1616,2250,0.58,0.42
36047043500,"Census Tract 435, Kings County, New York",4709,812,3897,0.83,0.17
36047043600,"Census Tract 436, Kings County, New York",4694,1948,2746,0.59,0.41
36047043700,"Census Tract 437, Kings County, New York",5282,1149,4133,0.78,0.22
36047043800,"Census Tract 438, Kings County, New York",2905,1910,995,0.34,0.66
36047043900,"Census Tract 439, Kings County, New York",4097,654,3443,0.84,0.16
36047044000,"Census Tract 440, Kings County, New York",2878,2100,778,0.27,0.73
36047044100,"Census Tract 441, Kings County, New York",5526,1015,4511,0.82,0.18
36047044200,"Census Tract 442, Kings County, New York",2631,2316,315,0.12,0.88
36047044300,"Census Tract 443, Kings County, New York",5195,1385,3810,0.73,0.27
36047044400,"Census Tract 444, Kings County, New York",3260,2531,729,0.22,0.78
36047044500,"Census Tract 445, Kings County, New York",4207,1100,3107,0.74,0.26
36047044600,"Census Tract 446, Kings County, New York",2026,802,1224,0.6,0.4
36047044700,"Census Tract 447, Kings County, New York",2459,805,1654,0.67,0.33
36047044800,"Census Tract 448, Kings County, New York",1965,1454,511,0.26,0.74
36047044901,"Census Tract 449.01, Kings County, New York",2694,518,2176,0.81,0.19
36047044902,"Census Tract 449.02, Kings County, New York",44,20,24,0.55,0.45
36047045000,"Census Tract 450, Kings County, New York",645,561,84,0.13,0.87
36047045200,"Census Tract 452, Kings County, New York",2618,2327,291,0.11,0.89
36047045300,"Census Tract 453, Kings County, New York",1886,827,1059,0.56,0.44
36047045400,"Census Tract 454, Kings County, New York",2036,1587,449,0.22,0.78
36047045600,"Census Tract 456, Kings County, New York",2767,1481,1286,0.46,0.54
36047045800,"Census Tract 458, Kings County, New York",1558,1421,137,0.09,0.91
36047046000,"Census Tract 460, Kings County, New York",3828,1586,2242,0.59,0.41
36047046201,"Census Tract 462.01, Kings County, New York",2700,1693,1007,0.37,0.63
36047046202,"Census Tract 462.02, Kings County, New York",1891,1349,542,0.29,0.71
36047046400,"Census Tract 464, Kings County, New York",2732,2263,469,0.17,0.83
36047046800,"Census Tract 468, Kings County, New York",2138,1908,230,0.11,0.89
36047047000,"Census Tract 470, Kings County, New York",2823,2420,403,0.14,0.86
36047047200,"Census Tract 472, Kings County, New York",3099,2805,294,0.09,0.91
36047047400,"Census Tract 474, Kings County, New York",3232,2771,461,0.14,0.86
36047047600,"Census Tract 476, Kings County, New York",4054,3533,521,0.13,0.87
36047047700,"Census Tract 477, Kings County, New York",4226,2821,1405,0.33,0.67
36047047800,"Census Tract 478, Kings County, New York",5308,3428,1880,0.35,0.65
36047048000,"Census Tract 480, Kings County, New York",3824,2154,1670,0.44,0.56
36047048100,"Census Tract 481, Kings County, New York",3105,1658,1447,0.47,0.53
36047048200,"Census Tract 482, Kings County, New York",6122,2378,3744,0.61,0.39
36047048400,"Census Tract 484, Kings County, New York",5922,3306,2616,0.44,0.56
36047048500,"Census Tract 485, Kings County, New York",2470,1209,1261,0.51,0.49
36047048600,"Census Tract 486, Kings County, New York",3597,711,2886,0.8,0.2
36047048800,"Census Tract 488, Kings County, New York",4536,1931,2605,0.57,0.43
36047048900,"Census Tract 489, Kings County, New York",3757,62,3695,0.98,0.02
36047049000,"Census Tract 490, Kings County, New York",6036,2569,3467,0.57,0.43
36047049100,"Census Tract 491, Kings County, New York",6366,1338,5028,0.79,0.21
36047049200,"Census Tract 492, Kings County, New York",3366,1110,2256,0.67,0.33
36047049301,"Census Tract 493.01, Kings County, New York",1897,53,1844,0.97,0.03
36047049302,"Census Tract 493.02, Kings County, New York",5476,1515,3961,0.72,0.28
36047049400,"Census Tract 494, Kings County, New York",5527,2488,3039,0.55,0.45
36047049500,"Census Tract 495, Kings County, New York",3114,1739,1375,0.44,0.56
36047049600,"Census Tract 496, Kings County, New York",4646,1625,3021,0.65,0.35
36047049700,"Census Tract 497, Kings County, New York",3141,2253,888,0.28,0.72
36047049800,"Census Tract 498, Kings County, New York",4517,1818,2699,0.6,0.4
36047049900,"Census Tract 499, Kings County, New York",2147,1512,635,0.3,0.7
36047050001,"Census Tract 500.01, Kings County, New York",2062,1248,814,0.39,0.61
36047050002,"Census Tract 500.02, Kings County, New York",1607,941,666,0.41,0.59
36047050100,"Census Tract 501, Kings County, New York",2951,1964,987,0.33,0.67
36047050202,"Census Tract 502.02, Kings County, New York",2312,1700,612,0.26,0.74
36047050300,"Census Tract 503, Kings County, New York",2759,1680,1079,0.39,0.61
36047050401,"Census Tract 504.01, Kings County, New York",2997,1879,1118,0.37,0.63
36047050402,"Census Tract 504.02, Kings County, New York",2004,871,1133,0.57,0.43
36047050500,"Census Tract 505, Kings County, New York",4567,1222,3345,0.73,0.27
36047050600,"Census Tract 506, Kings County, New York",5612,1010,4602,0.82,0.18
36047050700,"Census Tract 507, Kings County, New York",3545,2625,920,0.26,0.74
36047050801,"Census Tract 508.01, Kings County, New York",4311,460,3851,0.89,0.11
36047050803,"Census Tract 508.03, Kings County, New York",2548,515,2033,0.8,0.2
36047050804,"Census Tract 508.04, Kings County, New York",6196,1358,4838,0.78,0.22
36047050900,"Census Tract 509, Kings County, New York",5112,4435,677,0.13,0.87
36047051001,"Census Tract 510.01, Kings County, New York",3740,469,3271,0.87,0.13
36047051002,"Census Tract 510.02, Kings County, New York",4600,593,4007,0.87,0.13
36047051100,"Census Tract 511, Kings County, New York",4545,1484,3061,0.67,0.33
36047051200,"Census Tract 512, Kings County, New York",5946,896,5050,0.85,0.15
36047051300,"Census Tract 513, Kings County, New York",5526,2711,2815,0.51,0.49
36047051400,"Census Tract 514, Kings County, New York",7023,1275,5748,0.82,0.18
36047051500,"Census Tract 515, Kings County, New York",2451,1658,793,0.32,0.68
36047051601,"Census Tract 516.01, Kings County, New York",5407,599,4808,0.89,0.11
36047051602,"Census Tract 516.02, Kings County, New York",3874,349,3525,0.91,0.09
36047051700,"Census Tract 517, Kings County, New York",2636,1841,795,0.3,0.7
36047051800,"Census Tract 518, Kings County, New York",3528,1045,2483,0.7,0.3
36047051900,"Census Tract 519, Kings County, New York",6101,4131,1970,0.32,0.68
36047052000,"Census Tract 520, Kings County, New York",4175,1175,3000,0.72,0.28
36047052300,"Census Tract 523, Kings County, New York",5405,1860,3545,0.66,0.34
36047052500,"Census Tract 525, Kings County, New York",3720,2050,1670,0.45,0.55
36047052600,"Census Tract 526, Kings County, New York",4353,1515,2838,0.65,0.35
36047052700,"Census Tract 527, Kings County, New York",6045,1745,4300,0.71,0.29
36047052800,"Census Tract 528, Kings County, New York",1804,869,935,0.52,0.48
36047052900,"Census Tract 529, Kings County, New York",4299,3839,460,0.11,0.89
36047053000,"Census Tract 530, Kings County, New York",3606,1808,1798,0.5,0.5
36047053101,"Census Tract 531.01, Kings County, New York",2997,2638,359,0.12,0.88
36047053102,"Census Tract 531.02, Kings County, New York",5890,5320,570,0.1,0.9
36047053200,"Census Tract 532, Kings County, New York",2510,1333,1177,0.47,0.53
36047053300,"Census Tract 533, Kings County, New York",7115,6540,575,0.08,0.92
36047053400,"Census Tract 534, Kings County, New York",4777,2523,2254,0.47,0.53
36047053500,"Census Tract 535, Kings County, New York",4469,3889,580,0.13,0.87
36047053700,"Census Tract 537, Kings County, New York",4304,3912,392,0.09,0.91
36047053800,"Census Tract 538, Kings County, New York",5535,3671,1864,0.34,0.66
36047053900,"Census Tract 539, Kings County, New York",2668,2114,554,0.21,0.79
36047054200,"Census Tract 542, Kings County, New York",4750,3559,1191,0.25,0.75
36047054300,"Census Tract 543, Kings County, New York",5,1,4,0.8,0.2
36047054400,"Census Tract 544, Kings County, New York",3785,2759,1026,0.27,0.73
36047054500,"Census Tract 545, Kings County, New York",7304,4402,2902,0.4,0.6
36047054600,"Census Tract 546, Kings County, New York",5409,3516,1893,0.35,0.65
36047054700,"Census Tract 547, Kings County, New York",7855,5764,2091,0.27,0.73
36047054800,"Census Tract 548, Kings County, New York",2189,1870,319,0.15,0.85
36047054900,"Census Tract 549, Kings County, New York",4748,3225,1523,0.32,0.68
36047055000,"Census Tract 550, Kings County, New York",3956,2699,1257,0.32,0.68
36047055100,"Census Tract 551, Kings County, New York",6343,3163,3180,0.5,0.5
36047055200,"Census Tract 552, Kings County, New York",3735,2266,1469,0.39,0.61
36047055300,"Census Tract 553, Kings County, New York",3078,1895,1183,0.38,0.62
36047055400,"Census Tract 554, Kings County, New York",4813,2780,2033,0.42,0.58
36047055500,"Census Tract 555, Kings County, New York",8688,5321,3367,0.39,0.61
36047055600,"Census Tract 556, Kings County, New York",3880,2853,1027,0.26,0.74
36047055700,"Census Tract 557, Kings County, New York",1848,1345,503,0.27,0.73
36047055800,"Census Tract 558, Kings County, New York",2736,1772,964,0.35,0.65
36047056000,"Census Tract 560, Kings County, New York",3882,3028,854,0.22,0.78
36047056100,"Census Tract 561, Kings County, New York",3460,2632,828,0.24,0.76
36047056200,"Census Tract 562, Kings County, New York",1695,1458,237,0.14,0.86
36047056301,"Census Tract 563.01, Kings County, New York",4923,2982,1941,0.39,0.61
36047056302,"Census Tract 563.02, Kings County, New York",2002,845,1157,0.58,0.42
36047056400,"Census Tract 564, Kings County, New York",2626,1815,811,0.31,0.69
36047056500,"Census Tract 565, Kings County, New York",3738,2699,1039,0.28,0.72
36047056600,"Census Tract 566, Kings County, New York",2548,1224,1324,0.52,0.48
36047056800,"Census Tract 568, Kings County, New York",1310,774,536,0.41,0.59
36047056900,"Census Tract 569, Kings County, New York",1624,1197,427,0.26,0.74
36047057000,"Census Tract 570, Kings County, New York",3534,1797,1737,0.49,0.51
36047057100,"Census Tract 571, Kings County, New York",4267,3468,799,0.19,0.81
36047057200,"Census Tract 572, Kings County, New York",5221,548,4673,0.9,0.1
36047057300,"Census Tract 573, Kings County, New York",2590,2061,529,0.2,0.8
36047057400,"Census Tract 574, Kings County, New York",2560,1039,1521,0.59,0.41
36047057500,"Census Tract 575, Kings County, New York",4902,3258,1644,0.34,0.66
36047057600,"Census Tract 576, Kings County, New York",2912,1130,1782,0.61,0.39
36047057800,"Census Tract 578, Kings County, New York",3332,1572,1760,0.53,0.47
36047057901,"Census Tract 579.01, Kings County, New York",1416,764,652,0.46,0.54
36047057902,"Census Tract 579.02, Kings County, New York",0,0,0,0,0
36047058000,"Census Tract 580, Kings County, New York",3502,1449,2053,0.59,0.41
36047058200,"Census Tract 582, Kings County, New York",3044,1578,1466,0.48,0.52
36047058400,"Census Tract 584, Kings County, New York",3797,2553,1244,0.33,0.67
36047058600,"Census Tract 586, Kings County, New York",2655,738,1917,0.72,0.28
36047058800,"Census Tract 588, Kings County, New York",3532,2345,1187,0.34,0.66
36047058901,"Census Tract 589.01, Kings County, New York",1781,1464,317,0.18,0.82
36047058902,"Census Tract 589.02, Kings County, New York",0,0,0,0,0
36047059000,"Census Tract 590, Kings County, New York",2014,693,1321,0.66,0.34
36047059100,"Census Tract 591, Kings County, New York",3856,2969,887,0.23,0.77
36047059200,"Census Tract 592, Kings County, New York",4268,2380,1888,0.44,0.56
36047059300,"Census Tract 593, Kings County, New York",2274,1645,629,0.28,0.72
36047059402,"Census Tract 594.02, Kings County, New York",5105,3212,1893,0.37,0.63
36047059403,"Census Tract 594.03, Kings County, New York",3779,1830,1949,0.52,0.48
36047059404,"Census Tract 594.04, Kings County, New York",4426,2421,2005,0.45,0.55
36047059600,"Census Tract 596, Kings County, New York",2569,2013,556,0.22,0.78
36047059800,"Census Tract 598, Kings County, New York",3617,2492,1125,0.31,0.69
36047060000,"Census Tract 600, Kings County, New York",6844,5226,1618,0.24,0.76
36047060600,"Census Tract 606, Kings County, New York",3178,2075,1103,0.35,0.65
36047060800,"Census Tract 608, Kings County, New York",4015,2811,1204,0.3,0.7
36047061002,"Census Tract 610.02, Kings County, New York",5064,4669,395,0.08,0.92
36047061003,"Census Tract 610.03, Kings County, New York",2418,613,1805,0.75,0.25
36047061004,"Census Tract 610.04, Kings County, New York",6669,5059,1610,0.24,0.76
36047061200,"Census Tract 612, Kings County, New York",1063,961,102,0.1,0.9
36047061600,"Census Tract 616, Kings County, New York",1854,1692,162,0.09,0.91
36047062000,"Census Tract 620, Kings County, New York",1767,1633,134,0.08,0.92
36047062200,"Census Tract 622, Kings County, New York",3325,2315,1010,0.3,0.7
36047062600,"Census Tract 626, Kings County, New York",3152,1554,1598,0.51,0.49
36047062800,"Census Tract 628, Kings County, New York",5222,3862,1360,0.26,0.74
36047063200,"Census Tract 632, Kings County, New York",1476,1073,403,0.27,0.73
36047063600,"Census Tract 636, Kings County, New York",1317,846,471,0.36,0.64
36047063800,"Census Tract 638, Kings County, New York",1617,1082,535,0.33,0.67
36047064000,"Census Tract 640, Kings County, New York",1620,1253,367,0.23,0.77
36047064200,"Census Tract 642, Kings County, New York",2865,2019,846,0.3,0.7
36047064400,"Census Tract 644, Kings County, New York",2702,1844,858,0.32,0.68
36047064600,"Census Tract 646, Kings County, New York",2226,1663,563,0.25,0.75
36047064800,"Census Tract 648, Kings County, New York",1993,1129,864,0.43,0.57
36047065000,"Census Tract 650, Kings County, New York",1439,335,1104,0.77,0.23
36047065200,"Census Tract 652, Kings County, New York",1197,743,454,0.38,0.62
36047065400,"Census Tract 654, Kings County, New York",1681,1229,452,0.27,0.73
36047065600,"Census Tract 656, Kings County, New York",1795,1323,472,0.26,0.74
36047065800,"Census Tract 658, Kings County, New York",1844,1165,679,0.37,0.63
36047066000,"Census Tract 660, Kings County, New York",1762,1229,533,0.3,0.7
36047066200,"Census Tract 662, Kings County, New York",1497,849,648,0.43,0.57
36047066600,"Census Tract 666, Kings County, New York",1,0,1,1,0
36047067000,"Census Tract 670, Kings County, New York",2876,466,2410,0.84,0.16
36047067200,"Census Tract 672, Kings County, New York",1435,135,1300,0.91,0.09
36047067400,"Census Tract 674, Kings County, New York",1992,241,1751,0.88,0.12
36047067600,"Census Tract 676, Kings County, New York",1622,133,1489,0.92,0.08
36047067800,"Census Tract 678, Kings County, New York",2874,259,2615,0.91,0.09
36047068000,"Census Tract 680, Kings County, New York",1887,206,1681,0.89,0.11
36047068200,"Census Tract 682, Kings County, New York",2489,381,2108,0.85,0.15
36047068600,"Census Tract 686, Kings County, New York",1749,710,1039,0.59,0.41
36047068800,"Census Tract 688, Kings County, New York",1706,383,1323,0.78,0.22
36047069000,"Census Tract 690, Kings County, New York",1880,274,1606,0.85,0.15
36047069200,"Census Tract 692, Kings County, New York",2512,220,2292,0.91,0.09
36047069601,"Census Tract 696.01, Kings County, New York",3932,1131,2801,0.71,0.29
36047069602,"Census Tract 696.02, Kings County, New York",6275,3578,2697,0.43,0.57
36047069800,"Census Tract 698, Kings County, New York",1417,1057,360,0.25,0.75
36047070000,"Census Tract 700, Kings County, New York",1650,1356,294,0.18,0.82
36047070201,"Census Tract 702.01, Kings County, New York",6719,5918,801,0.12,0.88
36047070202,"Census Tract 702.02, Kings County, New York",21,12,9,0.43,0.57
36047070203,"Census Tract 702.03, Kings County, New York",0,0,0,0,0
36047070601,"Census Tract 706.01, Kings County, New York",2703,2342,361,0.13,0.87
36047070602,"Census Tract 706.02, Kings County, New York",4,2,2,0.5,0.5
36047072000,"Census Tract 720, Kings County, New York",2205,94,2111,0.96,0.04
36047072200,"Census Tract 722, Kings County, New York",2893,74,2819,0.97,0.03
36047072400,"Census Tract 724, Kings County, New York",1911,35,1876,0.98,0.02
36047072600,"Census Tract 726, Kings County, New York",2582,52,2530,0.98,0.02
36047072800,"Census Tract 728, Kings County, New York",3645,145,3500,0.96,0.04
36047073000,"Census Tract 730, Kings County, New York",2170,100,2070,0.95,0.05
36047073200,"Census Tract 732, Kings County, New York",2173,66,2107,0.97,0.03
36047073400,"Census Tract 734, Kings County, New York",1818,63,1755,0.97,0.03
36047073600,"Census Tract 736, Kings County, New York",3473,167,3306,0.95,0.05
36047073800,"Census Tract 738, Kings County, New York",3290,964,2326,0.71,0.29
36047074000,"Census Tract 740, Kings County, New York",3446,307,3139,0.91,0.09
36047074200,"Census Tract 742, Kings County, New York",3023,1269,1754,0.58,0.42
36047074400,"Census Tract 744, Kings County, New York",2481,2179,302,0.12,0.88
36047074600,"Census Tract 746, Kings County, New York",2100,1334,766,0.36,0.64
36047074800,"Census Tract 748, Kings County, New York",1936,1333,603,0.31,0.69
36047075000,"Census Tract 750, Kings County, New York",2928,2162,766,0.26,0.74
36047075200,"Census Tract 752, Kings County, New York",1042,961,81,0.08,0.92
36047075400,"Census Tract 754, Kings County, New York",1402,1343,59,0.04,0.96
36047075600,"Census Tract 756, Kings County, New York",1934,1560,374,0.19,0.81
36047075800,"Census Tract 758, Kings County, New York",2005,1654,351,0.18,0.82
36047076000,"Census Tract 760, Kings County, New York",2832,2139,693,0.24,0.76
36047076200,"Census Tract 762, Kings County, New York",4391,2127,2264,0.52,0.48
36047076400,"Census Tract 764, Kings County, New York",3783,941,2842,0.75,0.25
36047076600,"Census Tract 766, Kings County, New York",1990,236,1754,0.88,0.12
36047076800,"Census Tract 768, Kings County, New York",4049,2687,1362,0.34,0.66
36047077000,"Census Tract 770, Kings County, New York",2776,311,2465,0.89,0.11
36047077200,"Census Tract 772, Kings County, New York",3070,1007,2063,0.67,0.33
36047077400,"Census Tract 774, Kings County, New York",3029,545,2484,0.82,0.18
36047077600,"Census Tract 776, Kings County, New York",3784,209,3575,0.94,0.06
36047078000,"Census Tract 780, Kings County, New York",2197,54,2143,0.98,0.02
36047078200,"Census Tract 782, Kings County, New York",4081,65,4016,0.98,0.02
36047078400,"Census Tract 784, Kings County, New York",2441,137,2304,0.94,0.06
36047078601,"Census Tract 786.01, Kings County, New York",2374,90,2284,0.96,0.04
36047078602,"Census Tract 786.02, Kings County, New York",2073,141,1932,0.93,0.07
36047078801,"Census Tract 788.01, Kings County, New York",2040,77,1963,0.96,0.04
36047078802,"Census Tract 788.02, Kings County, New York",1328,18,1310,0.99,0.01
36047079001,"Census Tract 790.01, Kings County, New York",1347,133,1214,0.9,0.1
36047079002,"Census Tract 790.02, Kings County, New York",3769,181,3588,0.95,0.05
36047079201,"Census Tract 792.01, Kings County, New York",1743,128,1615,0.93,0.07
36047079202,"Census Tract 792.02, Kings County, New York",3171,140,3031,0.96,0.04
36047079400,"Census Tract 794, Kings County, New York",2742,203,2539,0.93,0.07
36047079601,"Census Tract 796.01, Kings County, New York",4125,1010,3115,0.76,0.24
36047079602,"Census Tract 796.02, Kings County, New York",4489,711,3778,0.84,0.16
36047079801,"Census Tract 798.01, Kings County, New York",2957,836,2121,0.72,0.28
36047079802,"Census Tract 798.02, Kings County, New York",5647,1584,4063,0.72,0.28
36047080000,"Census Tract 800, Kings County, New York",3562,1019,2543,0.71,0.29
36047080200,"Census Tract 802, Kings County, New York",4521,802,3719,0.82,0.18
36047080400,"Census Tract 804, Kings County, New York",3327,661,2666,0.8,0.2
36047080600,"Census Tract 806, Kings County, New York",3781,1442,2339,0.62,0.38
36047080800,"Census Tract 808, Kings County, New York",1940,179,1761,0.91,0.09
36047081000,"Census Tract 810, Kings County, New York",2907,520,2387,0.82,0.18
36047081400,"Census Tract 814, Kings County, New York",3121,172,2949,0.94,0.06
36047081600,"Census Tract 816, Kings County, New York",2580,101,2479,0.96,0.04
36047081800,"Census Tract 818, Kings County, New York",4830,565,4265,0.88,0.12
36047082000,"Census Tract 820, Kings County, New York",5495,609,4886,0.89,0.11
36047082200,"Census Tract 822, Kings County, New York",7201,866,6335,0.88,0.12
36047082400,"Census Tract 824, Kings County, New York",4963,303,4660,0.94,0.06
36047082600,"Census Tract 826, Kings County, New York",5165,256,4909,0.95,0.05
36047082800,"Census Tract 828, Kings County, New York",4206,211,3995,0.95,0.05
36047083000,"Census Tract 830, Kings County, New York",6167,122,6045,0.98,0.02
36047083200,"Census Tract 832, Kings County, New York",2362,43,2319,0.98,0.02
36047083400,"Census Tract 834, Kings County, New York",1733,29,1704,0.98,0.02
36047083600,"Census Tract 836, Kings County, New York",2160,20,2140,0.99,0.01
36047083800,"Census Tract 838, Kings County, New York",2226,34,2192,0.98,0.02
36047084000,"Census Tract 840, Kings County, New York",2324,36,2288,0.98,0.02
36047084600,"Census Tract 846, Kings County, New York",1986,23,1963,0.99,0.01
36047084800,"Census Tract 848, Kings County, New York",1728,16,1712,0.99,0.01
36047085000,"Census Tract 850, Kings County, New York",1509,26,1483,0.98,0.02
36047085200,"Census Tract 852, Kings County, New York",32,0,32,1,0
36047085400,"Census Tract 854, Kings County, New York",1962,64,1898,0.97,0.03
36047085600,"Census Tract 856, Kings County, New York",3568,138,3430,0.96,0.04
36047085800,"Census Tract 858, Kings County, New York",2474,42,2432,0.98,0.02
36047086000,"Census Tract 860, Kings County, New York",3809,39,3770,0.99,0.01
36047086200,"Census Tract 862, Kings County, New York",3427,39,3388,0.99,0.01
36047086400,"Census Tract 864, Kings County, New York",2499,45,2454,0.98,0.02
36047086600,"Census Tract 866, Kings County, New York",3385,135,3250,0.96,0.04
36047086800,"Census Tract 868, Kings County, New York",3413,86,3327,0.97,0.03
36047087000,"Census Tract 870, Kings County, New York",3570,99,3471,0.97,0.03
36047087200,"Census Tract 872, Kings County, New York",3128,132,2996,0.96,0.04
36047087401,"Census Tract 874.01, Kings County, New York",3740,619,3121,0.83,0.17
36047087600,"Census Tract 876, Kings County, New York",2098,538,1560,0.74,0.26
36047087800,"Census Tract 878, Kings County, New York",2730,78,2652,0.97,0.03
36047088001,"Census Tract 880.01, Kings County, New York",2127,187,1940,0.91,0.09
36047088002,"Census Tract 880.02, Kings County, New York",1374,140,1234,0.9,0.1
36047088200,"Census Tract 882, Kings County, New York",6804,175,6629,0.97,0.03
36047088400,"Census Tract 884, Kings County, New York",5513,105,5408,0.98,0.02
36047088600,"Census Tract 886, Kings County, New York",4547,68,4479,0.99,0.01
36047088800,"Census Tract 888, Kings County, New York",4001,18,3983,1,0
36047089000,"Census Tract 890, Kings County, New York",6683,150,6533,0.98,0.02
36047089200,"Census Tract 892, Kings County, New York",3673,70,3603,0.98,0.02
36047089400,"Census Tract 894, Kings County, New York",3834,43,3791,0.99,0.01
36047089600,"Census Tract 896, Kings County, New York",4081,71,4010,0.98,0.02
36047089800,"Census Tract 898, Kings County, New York",2329,36,2293,0.98,0.02
36047090000,"Census Tract 900, Kings County, New York",5434,49,5385,0.99,0.01
36047090200,"Census Tract 902, Kings County, New York",3817,77,3740,0.98,0.02
36047090600,"Census Tract 906, Kings County, New York",4534,62,4472,0.99,0.01
36047090800,"Census Tract 908, Kings County, New York",5893,158,5735,0.97,0.03
36047091000,"Census Tract 910, Kings County, New York",5814,69,5745,0.99,0.01
36047091200,"Census Tract 912, Kings County, New York",6572,53,6519,0.99,0.01
36047091600,"Census Tract 916, Kings County, New York",5309,62,5247,0.99,0.01
36047091800,"Census Tract 918, Kings County, New York",2703,29,2674,0.99,0.01
36047092000,"Census Tract 920, Kings County, New York",3491,29,3462,0.99,0.01
36047092200,"Census Tract 922, Kings County, New York",3031,19,3012,0.99,0.01
36047092400,"Census Tract 924, Kings County, New York",3628,73,3555,0.98,0.02
36047092800,"Census Tract 928, Kings County, New York",2861,57,2804,0.98,0.02
36047093000,"Census Tract 930, Kings County, New York",2567,8,2559,1,0
36047093200,"Census Tract 932, Kings County, New York",1277,13,1264,0.99,0.01
36047093400,"Census Tract 934, Kings County, New York",2466,40,2426,0.98,0.02
36047093600,"Census Tract 936, Kings County, New York",1854,4,1850,1,0
36047093800,"Census Tract 938, Kings County, New York",2662,67,2595,0.97,0.03
36047094401,"Census Tract 944.01, Kings County, New York",3447,58,3389,0.98,0.02
36047094402,"Census Tract 944.02, Kings County, New York",2810,66,2744,0.98,0.02
36047094600,"Census Tract 946, Kings County, New York",2079,25,2054,0.99,0.01
36047095000,"Census Tract 950, Kings County, New York",3170,111,3059,0.96,0.04
36047095400,"Census Tract 954, Kings County, New York",5156,100,5056,0.98,0.02
36047095600,"Census Tract 956, Kings County, New York",4391,168,4223,0.96,0.04
36047095800,"Census Tract 958, Kings County, New York",3770,119,3651,0.97,0.03
36047096000,"Census Tract 960, Kings County, New York",6,0,6,1,0
36047096200,"Census Tract 962, Kings County, New York",1701,78,1623,0.95,0.05
36047096400,"Census Tract 964, Kings County, New York",2621,146,2475,0.94,0.06
36047096600,"Census Tract 966, Kings County, New York",2353,96,2257,0.96,0.04
36047096800,"Census Tract 968, Kings County, New York",1555,65,1490,0.96,0.04
36047097000,"Census Tract 970, Kings County, New York",2357,113,2244,0.95,0.05
36047097400,"Census Tract 974, Kings County, New York",2911,145,2766,0.95,0.05
36047098200,"Census Tract 982, Kings County, New York",4076,22,4054,0.99,0.01
36047098400,"Census Tract 984, Kings County, New York",2074,40,2034,0.98,0.02
36047098600,"Census Tract 986, Kings County, New York",2814,50,2764,0.98,0.02
36047098800,"Census Tract 988, Kings County, New York",3083,90,2993,0.97,0.03
36047099000,"Census Tract 990, Kings County, New York",1652,63,1589,0.96,0.04
36047099200,"Census Tract 992, Kings County, New York",2056,108,1948,0.95,0.05
36047099400,"Census Tract 994, Kings County, New York",2116,96,2020,0.95,0.05
36047099600,"Census Tract 996, Kings County, New York",4052,197,3855,0.95,0.05
36047099800,"Census Tract 998, Kings County, New York",4234,148,4086,0.97,0.03
36047100400,"Census Tract 1004, Kings County, New York",2901,51,2850,0.98,0.02
36047100600,"Census Tract 1006, Kings County, New York",2662,152,2510,0.94,0.06
36047100800,"Census Tract 1008, Kings County, New York",2189,124,2065,0.94,0.06
36047101000,"Census Tract 1010, Kings County, New York",2605,144,2461,0.94,0.06
36047101200,"Census Tract 1012, Kings County, New York",2115,90,2025,0.96,0.04
36047101400,"Census Tract 1014, Kings County, New York",2268,84,2184,0.96,0.04
36047101600,"Census Tract 1016, Kings County, New York",1551,41,1510,0.97,0.03
36047101800,"Census Tract 1018, Kings County, New York",2030,98,1932,0.95,0.05
36047102000,"Census Tract 1020, Kings County, New York",2186,111,2075,0.95,0.05
36047102200,"Census Tract 1022, Kings County, New York",2313,131,2182,0.94,0.06
36047102400,"Census Tract 1024, Kings County, New York",2257,131,2126,0.94,0.06
36047102600,"Census Tract 1026, Kings County, New York",2973,120,2853,0.96,0.04
36047102801,"Census Tract 1028.01, Kings County, New York",1754,53,1701,0.97,0.03
36047102802,"Census Tract 1028.02, Kings County, New York",5,0,5,1,0
36047103401,"Census Tract 1034.01, Kings County, New York",3980,156,3824,0.96,0.04
36047103402,"Census Tract 1034.02, Kings County, New York",0,0,0,0,0
36047105801,"Census Tract 1058.01, Kings County, New York",7013,1387,5626,0.8,0.2
36047105804,"Census Tract 1058.04, Kings County, New York",6482,1152,5330,0.82,0.18
36047107001,"Census Tract 1070.01, Kings County, New York",3543,56,3487,0.98,0.02
36047107002,"Census Tract 1070.02, Kings County, New York",0,0,0,0,0
36047107003,"Census Tract 1070.03, Kings County, New York",0,0,0,0,0
36047107800,"Census Tract 1078, Kings County, New York",4112,64,4048,0.98,0.02
36047109800,"Census Tract 1098, Kings County, New York",2290,47,2243,0.98,0.02
36047110400,"Census Tract 1104, Kings County, New York",5068,87,4981,0.98,0.02
36047110600,"Census Tract 1106, Kings County, New York",4558,46,4512,0.99,0.01
36047111000,"Census Tract 1110, Kings County, New York",3037,24,3013,0.99,0.01
36047111600,"Census Tract 1116, Kings County, New York",3434,56,3378,0.98,0.02
36047111800,"Census Tract 1118, Kings County, New York",3507,98,3409,0.97,0.03
36047112000,"Census Tract 1120, Kings County, New York",3480,52,3428,0.99,0.01
36047112200,"Census Tract 1122, Kings County, New York",3514,81,3433,0.98,0.02
36047112400,"Census Tract 1124, Kings County, New York",4288,92,4196,0.98,0.02
36047112600,"Census Tract 1126, Kings County, New York",4368,56,4312,0.99,0.01
36047112800,"Census Tract 1128, Kings County, New York",4461,173,4288,0.96,0.04
36047113000,"Census Tract 1130, Kings County, New York",4460,79,4381,0.98,0.02
36047113200,"Census Tract 1132, Kings County, New York",2427,28,2399,0.99,0.01
36047113400,"Census Tract 1134, Kings County, New York",2658,59,2599,0.98,0.02
36047114201,"Census Tract 1142.01, Kings County, New York",1880,86,1794,0.95,0.05
36047114202,"Census Tract 1142.02, Kings County, New York",2670,128,2542,0.95,0.05
36047114400,"Census Tract 1144, Kings County, New York",2414,72,2342,0.97,0.03
36047114600,"Census Tract 1146, Kings County, New York",3134,74,3060,0.98,0.02
36047115000,"Census Tract 1150, Kings County, New York",3123,59,3064,0.98,0.02
36047115200,"Census Tract 1152, Kings County, New York",3496,80,3416,0.98,0.02
36047115600,"Census Tract 1156, Kings County, New York",4452,110,4342,0.98,0.02
36047115800,"Census Tract 1158, Kings County, New York",3260,60,3200,0.98,0.02
36047116000,"Census Tract 1160, Kings County, New York",2630,12,2618,1,0
36047116200,"Census Tract 1162, Kings County, New York",2374,41,2333,0.98,0.02
36047116400,"Census Tract 1164, Kings County, New York",3275,52,3223,0.98,0.02
36047116600,"Census Tract 1166, Kings County, New York",3484,60,3424,0.98,0.02
36047116800,"Census Tract 1168, Kings County, New York",2273,58,2215,0.97,0.03
36047117000,"Census Tract 1170, Kings County, New York",1974,45,1929,0.98,0.02
36047117201,"Census Tract 1172.01, Kings County, New York",2602,49,2553,0.98,0.02
36047117202,"Census Tract 1172.02, Kings County, New York",4266,130,4136,0.97,0.03
36047117400,"Census Tract 1174, Kings County, New York",4331,103,4228,0.98,0.02
36047117601,"Census Tract 1176.01, Kings County, New York",2760,110,2650,0.96,0.04
36047117602,"Census Tract 1176.02, Kings County, New York",3492,90,3402,0.97,0.03
36047117800,"Census Tract 1178, Kings County, New York",1820,30,1790,0.98,0.02
36047118000,"Census Tract 1180, Kings County, New York",7,0,7,1,0
36047118201,"Census Tract 1182.01, Kings County, New York",3345,79,3266,0.98,0.02
36047118202,"Census Tract 1182.02, Kings County, New York",3275,75,3200,0.98,0.02
36047118400,"Census Tract 1184, Kings County, New York",5434,113,5321,0.98,0.02
36047118600,"Census Tract 1186, Kings County, New York",3147,79,3068,0.97,0.03
36047118800,"Census Tract 1188, Kings County, New York",5156,119,5037,0.98,0.02
36047119000,"Census Tract 1190, Kings County, New York",2217,63,2154,0.97,0.03
36047119200,"Census Tract 1192, Kings County, New York",3636,73,3563,0.98,0.02
36047119400,"Census Tract 1194, Kings County, New York",4320,69,4251,0.98,0.02
36047119600,"Census Tract 1196, Kings County, New York",6458,109,6349,0.98,0.02
36047119800,"Census Tract 1198, Kings County, New York",3696,133,3563,0.96,0.04
36047120000,"Census Tract 1200, Kings County, New York",2873,73,2800,0.97,0.03
36047120200,"Census Tract 1202, Kings County, New York",1972,33,1939,0.98,0.02
36047120801,"Census Tract 1208.01, Kings County, New York",3999,59,3940,0.99,0.01
36047120802,"Census Tract 1208.02, Kings County, New York",3770,16,3754,1,0
36047120803,"Census Tract 1208.03, Kings County, New York",2010,86,1924,0.96,0.04
36047121000,"Census Tract 1210, Kings County, New York",3688,11,3677,1,0
36047121400,"Census Tract 1214, Kings County, New York",4100,59,4041,0.99,0.01
36047122000,"Census Tract 1220, Kings County, New York",6169,98,6071,0.98,0.02
36047123700,"Census Tract 1237, Kings County, New York",8586,7085,1501,0.17,0.83
36047150200,"Census Tract 1502, Kings County, New York",2616,1772,844,0.32,0.68
36047152200,"Census Tract 1522, Kings County, New York",3287,1493,1794,0.55,0.45
36047990100,"Census Tract 9901, Kings County, New York",0,0,0,0,0
36049950101,"Census Tract 9501.01, Lewis County, New York",2580,2458,122,0.05,0.95
36049950200,"Census Tract 9502, Lewis County, New York",4506,4243,263,0.06,0.94
36049950301,"Census Tract 9503.01, Lewis County, New York",3429,3128,301,0.09,0.91
36049950302,"Census Tract 9503.02, Lewis County, New York",4100,3817,283,0.07,0.93
36049950401,"Census Tract 9504.01, Lewis County, New York",2536,2392,144,0.06,0.94
36049950500,"Census Tract 9505, Lewis County, New York",2358,2186,172,0.07,0.93
36049950601,"Census Tract 9506.01, Lewis County, New York",1245,1177,68,0.05,0.95
36049950700,"Census Tract 9507, Lewis County, New York",4952,4700,252,0.05,0.95
36049950800,"Census Tract 9508, Lewis County, New York",876,841,35,0.04,0.96
36051030100,"Census Tract 301, Livingston County, New York",4154,3730,424,0.1,0.9
36051030201,"Census Tract 302.01, Livingston County, New York",4613,4034,579,0.13,0.87
36051030203,"Census Tract 302.03, Livingston County, New York",2458,2221,237,0.1,0.9
36051030204,"Census Tract 302.04, Livingston County, New York",3540,3135,405,0.11,0.89
36051030300,"Census Tract 303, Livingston County, New York",3399,3070,329,0.1,0.9
36051030400,"Census Tract 304, Livingston County, New York",3536,3093,443,0.13,0.87
36051030500,"Census Tract 305, Livingston County, New York",2809,2121,688,0.24,0.76
36051030600,"Census Tract 306, Livingston County, New York",4154,3747,407,0.1,0.9
36051030701,"Census Tract 307.01, Livingston County, New York",2673,2488,185,0.07,0.93
36051030702,"Census Tract 307.02, Livingston County, New York",4824,4353,471,0.1,0.9
36051030800,"Census Tract 308, Livingston County, New York",5060,4462,598,0.12,0.88
36051030900,"Census Tract 309, Livingston County, New York",2898,2237,661,0.23,0.77
36051031000,"Census Tract 310, Livingston County, New York",875,380,495,0.57,0.43
36051031101,"Census Tract 311.01, Livingston County, New York",2009,1856,153,0.08,0.92
36051031102,"Census Tract 311.02, Livingston County, New York",2597,2420,177,0.07,0.93
36051031200,"Census Tract 312, Livingston County, New York",3451,3184,267,0.08,0.92
36051031300,"Census Tract 313, Livingston County, New York",4351,4121,230,0.05,0.95
36051031400,"Census Tract 314, Livingston County, New York",4433,3959,474,0.11,0.89
36053030101,"Census Tract 301.01, Madison County, New York",2340,2076,264,0.11,0.89
36053030102,"Census Tract 301.02, Madison County, New York",4674,4206,468,0.1,0.9
36053030103,"Census Tract 301.03, Madison County, New York",3315,2916,399,0.12,0.88
36053030200,"Census Tract 302, Madison County, New York",3405,3111,294,0.09,0.91
36053030300,"Census Tract 303, Madison County, New York",5363,4822,541,0.1,0.9
36053030401,"Census Tract 304.01, Madison County, New York",4931,4490,441,0.09,0.91
36053030402,"Census Tract 304.02, Madison County, New York",3103,2865,238,0.08,0.92
36053030403,"Census Tract 304.03, Madison County, New York",3736,3470,266,0.07,0.93
36053030404,"Census Tract 304.04, Madison County, New York",3024,2812,212,0.07,0.93
36053030501,"Census Tract 305.01, Madison County, New York",3112,2738,374,0.12,0.88
36053030502,"Census Tract 305.02, Madison County, New York",3628,3365,263,0.07,0.93
36053030601,"Census Tract 306.01, Madison County, New York",3099,2834,265,0.09,0.91
36053030602,"Census Tract 306.02, Madison County, New York",3470,3157,313,0.09,0.91
36053030701,"Census Tract 307.01, Madison County, New York",4284,3430,854,0.2,0.8
36053030702,"Census Tract 307.02, Madison County, New York",1890,1757,133,0.07,0.93
36053030800,"Census Tract 308, Madison County, New York",3250,3034,216,0.07,0.93
36053030900,"Census Tract 309, Madison County, New York",4269,3252,1017,0.24,0.76
36053031000,"Census Tract 310, Madison County, New York",4876,4560,316,0.06,0.94
36053031100,"Census Tract 311, Madison County, New York",2247,2070,177,0.08,0.92
36055000200,"Census Tract 2, Monroe County, New York",2621,409,2212,0.84,0.16
36055000700,"Census Tract 7, Monroe County, New York",1953,122,1831,0.94,0.06
36055001000,"Census Tract 10, Monroe County, New York",3354,2474,880,0.26,0.74
36055001300,"Census Tract 13, Monroe County, New York",1957,71,1886,0.96,0.04
36055001600,"Census Tract 16, Monroe County, New York",2747,186,2561,0.93,0.07
36055001800,"Census Tract 18, Monroe County, New York",5420,2057,3363,0.62,0.38
36055001900,"Census Tract 19, Monroe County, New York",2699,722,1977,0.73,0.27
36055002000,"Census Tract 20, Monroe County, New York",4658,1283,3375,0.72,0.28
36055002100,"Census Tract 21, Monroe County, New York",3693,902,2791,0.76,0.24
36055002200,"Census Tract 22, Monroe County, New York",3044,478,2566,0.84,0.16
36055002300,"Census Tract 23, Monroe County, New York",4366,704,3662,0.84,0.16
36055002400,"Census Tract 24, Monroe County, New York",3637,693,2944,0.81,0.19
36055002700,"Census Tract 27, Monroe County, New York",1477,37,1440,0.97,0.03
36055002900,"Census Tract 29, Monroe County, New York",3691,2897,794,0.22,0.78
36055003000,"Census Tract 30, Monroe County, New York",2089,1370,719,0.34,0.66
36055003101,"Census Tract 31.01, Monroe County, New York",2588,2266,322,0.12,0.88
36055003102,"Census Tract 31.02, Monroe County, New York",1908,1574,334,0.18,0.82
36055003200,"Census Tract 32, Monroe County, New York",2043,1030,1013,0.5,0.5
36055003300,"Census Tract 33, Monroe County, New York",1709,1104,605,0.35,0.65
36055003400,"Census Tract 34, Monroe County, New York",2304,1400,904,0.39,0.61
36055003500,"Census Tract 35, Monroe County, New York",1507,1189,318,0.21,0.79
36055003600,"Census Tract 36, Monroe County, New York",2642,1874,768,0.29,0.71
36055003700,"Census Tract 37, Monroe County, New York",2935,2291,644,0.22,0.78
36055003806,"Census Tract 38.06, Monroe County, New York",5321,2346,2975,0.56,0.44
36055003807,"Census Tract 38.07, Monroe County, New York",4302,2459,1843,0.43,0.57
36055003900,"Census Tract 39, Monroe County, New York",1861,136,1725,0.93,0.07
36055004000,"Census Tract 40, Monroe County, New York",1446,294,1152,0.8,0.2
36055004100,"Census Tract 41, Monroe County, New York",1731,294,1437,0.83,0.17
36055004602,"Census Tract 46.02, Monroe County, New York",2501,509,1992,0.8,0.2
36055004701,"Census Tract 47.01, Monroe County, New York",3081,771,2310,0.75,0.25
36055004702,"Census Tract 47.02, Monroe County, New York",2086,334,1752,0.84,0.16
36055004800,"Census Tract 48, Monroe County, New York",2293,199,2094,0.91,0.09
36055004900,"Census Tract 49, Monroe County, New York",1732,80,1652,0.95,0.05
36055005000,"Census Tract 50, Monroe County, New York",1857,116,1741,0.94,0.06
36055005100,"Census Tract 51, Monroe County, New York",1373,81,1292,0.94,0.06
36055005200,"Census Tract 52, Monroe County, New York",1468,58,1410,0.96,0.04
36055005400,"Census Tract 54, Monroe County, New York",3655,917,2738,0.75,0.25
36055005500,"Census Tract 55, Monroe County, New York",1914,136,1778,0.93,0.07
36055005600,"Census Tract 56, Monroe County, New York",2339,257,2082,0.89,0.11
36055005700,"Census Tract 57, Monroe County, New York",1920,235,1685,0.88,0.12
36055005800,"Census Tract 58, Monroe County, New York",3885,900,2985,0.77,0.23
36055005900,"Census Tract 59, Monroe County, New York",1625,248,1377,0.85,0.15
36055006000,"Census Tract 60, Monroe County, New York",3216,1909,1307,0.41,0.59
36055006100,"Census Tract 61, Monroe County, New York",2317,1908,409,0.18,0.82
36055006200,"Census Tract 62, Monroe County, New York",3098,491,2607,0.84,0.16
36055006300,"Census Tract 63, Monroe County, New York",3076,390,2686,0.87,0.13
36055006400,"Census Tract 64, Monroe County, New York",2510,113,2397,0.95,0.05
36055006500,"Census Tract 65, Monroe County, New York",1608,101,1507,0.94,0.06
36055006600,"Census Tract 66, Monroe County, New York",1931,186,1745,0.9,0.1
36055006700,"Census Tract 67, Monroe County, New York",2875,414,2461,0.86,0.14
36055006800,"Census Tract 68, Monroe County, New York",2730,597,2133,0.78,0.22
36055006900,"Census Tract 69, Monroe County, New York",2555,647,1908,0.75,0.25
36055007000,"Census Tract 70, Monroe County, New York",3303,1072,2231,0.68,0.32
36055007100,"Census Tract 71, Monroe County, New York",2986,637,2349,0.79,0.21
36055007500,"Census Tract 75, Monroe County, New York",2963,271,2692,0.91,0.09
36055007600,"Census Tract 76, Monroe County, New York",2824,2057,767,0.27,0.73
36055007700,"Census Tract 77, Monroe County, New York",2740,1849,891,0.33,0.67
36055007801,"Census Tract 78.01, Monroe County, New York",2465,2034,431,0.17,0.83
36055007802,"Census Tract 78.02, Monroe County, New York",1520,1280,240,0.16,0.84
36055007900,"Census Tract 79, Monroe County, New York",1838,167,1671,0.91,0.09
36055008000,"Census Tract 80, Monroe County, New York",2274,148,2126,0.93,0.07
36055008100,"Census Tract 81, Monroe County, New York",4368,639,3729,0.85,0.15
36055008200,"Census Tract 82, Monroe County, New York",3100,421,2679,0.86,0.14
36055008301,"Census Tract 83.01, Monroe County, New York",3834,988,2846,0.74,0.26
36055008400,"Census Tract 84, Monroe County, New York",2789,263,2526,0.91,0.09
36055008500,"Census Tract 85, Monroe County, New York",3602,2449,1153,0.32,0.68
36055008600,"Census Tract 86, Monroe County, New York",4531,2719,1812,0.4,0.6
36055008702,"Census Tract 87.02, Monroe County, New York",1500,390,1110,0.74,0.26
36055008801,"Census Tract 88.01, Monroe County, New York",6004,1575,4429,0.74,0.26
36055009200,"Census Tract 92, Monroe County, New York",1322,93,1229,0.93,0.07
36055009301,"Census Tract 93.01, Monroe County, New York",2554,316,2238,0.88,0.12
36055009302,"Census Tract 93.02, Monroe County, New York",1693,979,714,0.42,0.58
36055009401,"Census Tract 94.01, Monroe County, New York",2260,1051,1209,0.53,0.47
36055009402,"Census Tract 94.02, Monroe County, New York",2092,1065,1027,0.49,0.51
36055009403,"Census Tract 94.03, Monroe County, New York",653,185,468,0.72,0.28
36055009404,"Census Tract 94.04, Monroe County, New York",633,357,276,0.44,0.56
36055009500,"Census Tract 95, Monroe County, New York",3046,1270,1776,0.58,0.42
36055009601,"Census Tract 96.01, Monroe County, New York",1791,237,1554,0.87,0.13
36055009602,"Census Tract 96.02, Monroe County, New York",1618,250,1368,0.85,0.15
36055009605,"Census Tract 96.05, Monroe County, New York",3445,638,2807,0.81,0.19
36055010100,"Census Tract 101, Monroe County, New York",3555,3006,549,0.15,0.85
36055010200,"Census Tract 102, Monroe County, New York",3884,3479,405,0.1,0.9
36055010300,"Census Tract 103, Monroe County, New York",3737,3246,491,0.13,0.87
36055010400,"Census Tract 104, Monroe County, New York",5268,3504,1764,0.33,0.67
36055010500,"Census Tract 105, Monroe County, New York",4477,3898,579,0.13,0.87
36055010601,"Census Tract 106.01, Monroe County, New York",2697,1908,789,0.29,0.71
36055010602,"Census Tract 106.02, Monroe County, New York",3964,2897,1067,0.27,0.73
36055010700,"Census Tract 107, Monroe County, New York",3359,2759,600,0.18,0.82
36055010800,"Census Tract 108, Monroe County, New York",2902,2399,503,0.17,0.83
36055010901,"Census Tract 109.01, Monroe County, New York",5032,2170,2862,0.57,0.43
36055010902,"Census Tract 109.02, Monroe County, New York",3253,2235,1018,0.31,0.69
36055011000,"Census Tract 110, Monroe County, New York",5065,3651,1414,0.28,0.72
36055011100,"Census Tract 111, Monroe County, New York",4034,3189,845,0.21,0.79
36055011201,"Census Tract 112.01, Monroe County, New York",3528,3191,337,0.1,0.9
36055011203,"Census Tract 112.03, Monroe County, New York",2068,1861,207,0.1,0.9
36055011205,"Census Tract 112.05, Monroe County, New York",5775,5188,587,0.1,0.9
36055011207,"Census Tract 112.07, Monroe County, New York",5319,4515,804,0.15,0.85
36055011209,"Census Tract 112.09, Monroe County, New York",4127,3376,751,0.18,0.82
36055011210,"Census Tract 112.10, Monroe County, New York",1206,1114,92,0.08,0.92
36055011302,"Census Tract 113.02, Monroe County, New York",5755,5147,608,0.11,0.89
36055011303,"Census Tract 113.03, Monroe County, New York",3007,2751,256,0.09,0.91
36055011304,"Census Tract 113.04, Monroe County, New York",4963,4381,582,0.12,0.88
36055011401,"Census Tract 114.01, Monroe County, New York",3419,2579,840,0.25,0.75
36055011402,"Census Tract 114.02, Monroe County, New York",3550,3184,366,0.1,0.9
36055011403,"Census Tract 114.03, Monroe County, New York",2610,1933,677,0.26,0.74
36055011503,"Census Tract 115.03, Monroe County, New York",5892,5158,734,0.12,0.88
36055011504,"Census Tract 115.04, Monroe County, New York",7331,6352,979,0.13,0.87
36055011505,"Census Tract 115.05, Monroe County, New York",6414,5477,937,0.15,0.85
36055011506,"Census Tract 115.06, Monroe County, New York",3971,3588,383,0.1,0.9
36055011507,"Census Tract 115.07, Monroe County, New York",3969,3268,701,0.18,0.82
36055011601,"Census Tract 116.01, Monroe County, New York",5742,4989,753,0.13,0.87
36055011603,"Census Tract 116.03, Monroe County, New York",1230,1027,203,0.17,0.83
36055011604,"Census Tract 116.04, Monroe County, New York",2650,2343,307,0.12,0.88
36055011605,"Census Tract 116.05, Monroe County, New York",2239,1952,287,0.13,0.87
36055011705,"Census Tract 117.05, Monroe County, New York",2615,2348,267,0.1,0.9
36055011707,"Census Tract 117.07, Monroe County, New York",7072,6324,748,0.11,0.89
36055011708,"Census Tract 117.08, Monroe County, New York",3724,3341,383,0.1,0.9
36055011709,"Census Tract 117.09, Monroe County, New York",2853,2508,345,0.12,0.88
36055011710,"Census Tract 117.10, Monroe County, New York",5967,5171,796,0.13,0.87
36055011711,"Census Tract 117.11, Monroe County, New York",2046,1827,219,0.11,0.89
36055011712,"Census Tract 117.12, Monroe County, New York",5482,4761,721,0.13,0.87
36055011800,"Census Tract 118, Monroe County, New York",5345,4706,639,0.12,0.88
36055011901,"Census Tract 119.01, Monroe County, New York",6319,5201,1118,0.18,0.82
36055011903,"Census Tract 119.03, Monroe County, New York",1969,1783,186,0.09,0.91
36055011904,"Census Tract 119.04, Monroe County, New York",4085,3720,365,0.09,0.91
36055012000,"Census Tract 120, Monroe County, New York",2611,2128,483,0.18,0.82
36055012100,"Census Tract 121, Monroe County, New York",3725,3113,612,0.16,0.84
36055012201,"Census Tract 122.01, Monroe County, New York",5944,5089,855,0.14,0.86
36055012202,"Census Tract 122.02, Monroe County, New York",3630,3196,434,0.12,0.88
36055012301,"Census Tract 123.01, Monroe County, New York",5998,4827,1171,0.2,0.8
36055012304,"Census Tract 123.04, Monroe County, New York",4436,3566,870,0.2,0.8
36055012305,"Census Tract 123.05, Monroe County, New York",4502,3534,968,0.22,0.78
36055012307,"Census Tract 123.07, Monroe County, New York",2726,1685,1041,0.38,0.62
36055012308,"Census Tract 123.08, Monroe County, New York",3381,2668,713,0.21,0.79
36055012401,"Census Tract 124.01, Monroe County, New York",3003,2735,268,0.09,0.91
36055012402,"Census Tract 124.02, Monroe County, New York",6092,5572,520,0.09,0.91
36055012500,"Census Tract 125, Monroe County, New York",4316,3767,549,0.13,0.87
36055012600,"Census Tract 126, Monroe County, New York",5126,4331,795,0.16,0.84
36055012700,"Census Tract 127, Monroe County, New York",3913,3241,672,0.17,0.83
36055012800,"Census Tract 128, Monroe County, New York",4577,3256,1321,0.29,0.71
36055012900,"Census Tract 129, Monroe County, New York",5460,4085,1375,0.25,0.75
36055013003,"Census Tract 130.03, Monroe County, New York",1675,1292,383,0.23,0.77
36055013004,"Census Tract 130.04, Monroe County, New York",5052,3324,1728,0.34,0.66
36055013005,"Census Tract 130.05, Monroe County, New York",4621,2396,2225,0.48,0.52
36055013006,"Census Tract 130.06, Monroe County, New York",2397,1298,1099,0.46,0.54
36055013101,"Census Tract 131.01, Monroe County, New York",6633,4779,1854,0.28,0.72
36055013103,"Census Tract 131.03, Monroe County, New York",7916,5139,2777,0.35,0.65
36055013104,"Census Tract 131.04, Monroe County, New York",5405,3169,2236,0.41,0.59
36055013203,"Census Tract 132.03, Monroe County, New York",5504,4080,1424,0.26,0.74
36055013205,"Census Tract 132.05, Monroe County, New York",5713,3442,2271,0.4,0.6
36055013206,"Census Tract 132.06, Monroe County, New York",7467,4495,2972,0.4,0.6
36055013207,"Census Tract 132.07, Monroe County, New York",5980,4518,1462,0.24,0.76
36055013208,"Census Tract 132.08, Monroe County, New York",2478,1790,688,0.28,0.72
36055013300,"Census Tract 133, Monroe County, New York",3490,3128,362,0.1,0.9
36055013401,"Census Tract 134.01, Monroe County, New York",3906,2714,1192,0.31,0.69
36055013402,"Census Tract 134.02, Monroe County, New York",3415,2958,457,0.13,0.87
36055013503,"Census Tract 135.03, Monroe County, New York",5501,4884,617,0.11,0.89
36055013505,"Census Tract 135.05, Monroe County, New York",3777,2723,1054,0.28,0.72
36055013507,"Census Tract 135.07, Monroe County, New York",5667,4864,803,0.14,0.86
36055013508,"Census Tract 135.08, Monroe County, New York",4361,3869,492,0.11,0.89
36055013509,"Census Tract 135.09, Monroe County, New York",2657,2211,446,0.17,0.83
36055013510,"Census Tract 135.10, Monroe County, New York",3600,3011,589,0.16,0.84
36055013511,"Census Tract 135.11, Monroe County, New York",2455,1554,901,0.37,0.63
36055013601,"Census Tract 136.01, Monroe County, New York",4895,3342,1553,0.32,0.68
36055013603,"Census Tract 136.03, Monroe County, New York",5619,4627,992,0.18,0.82
36055013604,"Census Tract 136.04, Monroe County, New York",5742,4027,1715,0.3,0.7
36055013701,"Census Tract 137.01, Monroe County, New York",2274,1701,573,0.25,0.75
36055013702,"Census Tract 137.02, Monroe County, New York",3594,2746,848,0.24,0.76
36055013800,"Census Tract 138, Monroe County, New York",5787,4029,1758,0.3,0.7
36055013901,"Census Tract 139.01, Monroe County, New York",3912,2909,1003,0.26,0.74
36055013902,"Census Tract 139.02, Monroe County, New York",4207,2136,2071,0.49,0.51
36055014001,"Census Tract 140.01, Monroe County, New York",5039,4015,1024,0.2,0.8
36055014003,"Census Tract 140.03, Monroe County, New York",4641,3369,1272,0.27,0.73
36055014004,"Census Tract 140.04, Monroe County, New York",3990,2742,1248,0.31,0.69
36055014102,"Census Tract 141.02, Monroe County, New York",3729,2788,941,0.25,0.75
36055014103,"Census Tract 141.03, Monroe County, New York",4336,3346,990,0.23,0.77
36055014104,"Census Tract 141.04, Monroe County, New York",3822,3076,746,0.2,0.8
36055014202,"Census Tract 142.02, Monroe County, New York",7473,5751,1722,0.23,0.77
36055014204,"Census Tract 142.04, Monroe County, New York",2565,1901,664,0.26,0.74
36055014205,"Census Tract 142.05, Monroe County, New York",3012,2054,958,0.32,0.68
36055014206,"Census Tract 142.06, Monroe County, New York",3519,2439,1080,0.31,0.69
36055014301,"Census Tract 143.01, Monroe County, New York",2927,1849,1078,0.37,0.63
36055014302,"Census Tract 143.02, Monroe County, New York",4956,3440,1516,0.31,0.69
36055014400,"Census Tract 144, Monroe County, New York",4715,3165,1550,0.33,0.67
36055014501,"Census Tract 145.01, Monroe County, New York",4550,3807,743,0.16,0.84
36055014503,"Census Tract 145.03, Monroe County, New York",3300,2532,768,0.23,0.77
36055014504,"Census Tract 145.04, Monroe County, New York",5401,4023,1378,0.26,0.74
36055014505,"Census Tract 145.05, Monroe County, New York",5309,4254,1055,0.2,0.8
36055014601,"Census Tract 146.01, Monroe County, New York",5580,4551,1029,0.18,0.82
36055014602,"Census Tract 146.02, Monroe County, New York",4983,3516,1467,0.29,0.71
36055014700,"Census Tract 147, Monroe County, New York",4897,4187,710,0.14,0.86
36055014802,"Census Tract 148.02, Monroe County, New York",5281,4835,446,0.08,0.92
36055014803,"Census Tract 148.03, Monroe County, New York",3797,3504,293,0.08,0.92
36055014805,"Census Tract 148.05, Monroe County, New York",3464,3070,394,0.11,0.89
36055014806,"Census Tract 148.06, Monroe County, New York",3675,3316,359,0.1,0.9
36055014901,"Census Tract 149.01, Monroe County, New York",5614,4971,643,0.11,0.89
36055014903,"Census Tract 149.03, Monroe County, New York",5099,4621,478,0.09,0.91
36055014905,"Census Tract 149.05, Monroe County, New York",5640,4821,819,0.15,0.85
36055014906,"Census Tract 149.06, Monroe County, New York",3917,3480,437,0.11,0.89
36055015000,"Census Tract 150, Monroe County, New York",5586,5120,466,0.08,0.92
36055015101,"Census Tract 151.01, Monroe County, New York",4651,4091,560,0.12,0.88
36055015102,"Census Tract 151.02, Monroe County, New York",4074,3615,459,0.11,0.89
36055015200,"Census Tract 152, Monroe County, New York",6904,5981,923,0.13,0.87
36055015301,"Census Tract 153.01, Monroe County, New York",2143,1530,613,0.29,0.71
36055015303,"Census Tract 153.03, Monroe County, New York",3154,2629,525,0.17,0.83
36055015304,"Census Tract 153.04, Monroe County, New York",3933,3217,716,0.18,0.82
36055015400,"Census Tract 154, Monroe County, New York",4014,3495,519,0.13,0.87
36055980000,"Census Tract 9800, Monroe County, New York",0,0,0,0,0
36055980100,"Census Tract 9801, Monroe County, New York",31,24,7,0.23,0.77
36055980200,"Census Tract 9802, Monroe County, New York",17,16,1,0.06,0.94
36055990000,"Census Tract 9900, Monroe County, New York",0,0,0,0,0
36057070200,"Census Tract 702, Montgomery County, New York",2242,1345,897,0.4,0.6
36057070300,"Census Tract 703, Montgomery County, New York",2060,834,1226,0.6,0.4
36057070400,"Census Tract 704, Montgomery County, New York",1996,1189,807,0.4,0.6
36057070500,"Census Tract 705, Montgomery County, New York",2703,1820,883,0.33,0.67
36057070600,"Census Tract 706, Montgomery County, New York",2011,1042,969,0.48,0.52
36057070700,"Census Tract 707, Montgomery County, New York",2625,1731,894,0.34,0.66
36057070800,"Census Tract 708, Montgomery County, New York",2959,1459,1500,0.51,0.49
36057070900,"Census Tract 709, Montgomery County, New York",1623,666,957,0.59,0.41
36057072100,"Census Tract 721, Montgomery County, New York",5557,4878,679,0.12,0.88
36057072200,"Census Tract 722, Montgomery County, New York",3572,3211,361,0.1,0.9
36057072300,"Census Tract 723, Montgomery County, New York",3189,2962,227,0.07,0.93
36057072400,"Census Tract 724, Montgomery County, New York",2598,2358,240,0.09,0.91
36057072500,"Census Tract 725, Montgomery County, New York",4166,3741,425,0.1,0.9
36057072600,"Census Tract 726, Montgomery County, New York",3660,3235,425,0.12,0.88
36057072700,"Census Tract 727, Montgomery County, New York",4549,4134,415,0.09,0.91
36057072800,"Census Tract 728, Montgomery County, New York",4022,3632,390,0.1,0.9
36059300100,"Census Tract 3001, Nassau County, New York",5619,4680,939,0.17,0.83
36059300300,"Census Tract 3003, Nassau County, New York",4680,3325,1355,0.29,0.71
36059300400,"Census Tract 3004, Nassau County, New York",6465,4442,2023,0.31,0.69
36059300500,"Census Tract 3005, Nassau County, New York",5847,4355,1492,0.26,0.74
36059300600,"Census Tract 3006, Nassau County, New York",6740,3703,3037,0.45,0.55
36059300700,"Census Tract 3007, Nassau County, New York",6604,4010,2594,0.39,0.61
36059300800,"Census Tract 3008, Nassau County, New York",4358,1702,2656,0.61,0.39
36059300901,"Census Tract 3009.01, Nassau County, New York",2828,1039,1789,0.63,0.37
36059300902,"Census Tract 3009.02, Nassau County, New York",5464,3245,2219,0.41,0.59
36059301000,"Census Tract 3010, Nassau County, New York",5706,4763,943,0.17,0.83
36059301101,"Census Tract 3011.01, Nassau County, New York",6956,3195,3761,0.54,0.46
36059301102,"Census Tract 3011.02, Nassau County, New York",4582,3507,1075,0.23,0.77
36059301200,"Census Tract 3012, Nassau County, New York",6191,4710,1481,0.24,0.76
36059301300,"Census Tract 3013, Nassau County, New York",4944,2467,2477,0.5,0.5
36059301400,"Census Tract 3014, Nassau County, New York",2193,1684,509,0.23,0.77
36059301500,"Census Tract 3015, Nassau County, New York",3250,2525,725,0.22,0.78
36059301600,"Census Tract 3016, Nassau County, New York",4794,3423,1371,0.29,0.71
36059301700,"Census Tract 3017, Nassau County, New York",2809,2141,668,0.24,0.76
36059301800,"Census Tract 3018, Nassau County, New York",5076,2440,2636,0.52,0.48
36059301900,"Census Tract 3019, Nassau County, New York",3100,2166,934,0.3,0.7
36059302000,"Census Tract 3020, Nassau County, New York",5330,3680,1650,0.31,0.69
36059302101,"Census Tract 3021.01, Nassau County, New York",4431,3430,1001,0.23,0.77
36059302102,"Census Tract 3021.02, Nassau County, New York",3534,2712,822,0.23,0.77
36059302200,"Census Tract 3022, Nassau County, New York",3882,1644,2238,0.58,0.42
36059302300,"Census Tract 3023, Nassau County, New York",5044,1986,3058,0.61,0.39
36059302400,"Census Tract 3024, Nassau County, New York",5220,2867,2353,0.45,0.55
36059302501,"Census Tract 3025.01, Nassau County, New York",2865,1559,1306,0.46,0.54
36059302502,"Census Tract 3025.02, Nassau County, New York",2766,1645,1121,0.41,0.59
36059302600,"Census Tract 3026, Nassau County, New York",2519,1335,1184,0.47,0.53
36059302700,"Census Tract 3027, Nassau County, New York",4593,1455,3138,0.68,0.32
36059302800,"Census Tract 3028, Nassau County, New York",6607,2714,3893,0.59,0.41
36059302900,"Census Tract 3029, Nassau County, New York",4457,2419,2038,0.46,0.54
36059303000,"Census Tract 3030, Nassau County, New York",6038,2159,3879,0.64,0.36
36059303101,"Census Tract 3031.01, Nassau County, New York",3649,1287,2362,0.65,0.35
36059303102,"Census Tract 3031.02, Nassau County, New York",4398,1487,2911,0.66,0.34
36059303203,"Census Tract 3032.03, Nassau County, New York",3502,1102,2400,0.69,0.31
36059303204,"Census Tract 3032.04, Nassau County, New York",4483,1600,2883,0.64,0.36
36059303301,"Census Tract 3033.01, Nassau County, New York",3343,1814,1529,0.46,0.54
36059303302,"Census Tract 3033.02, Nassau County, New York",4248,3211,1037,0.24,0.76
36059303400,"Census Tract 3034, Nassau County, New York",2645,2060,585,0.22,0.78
36059303500,"Census Tract 3035, Nassau County, New York",5410,3444,1966,0.36,0.64
36059303600,"Census Tract 3036, Nassau County, New York",8658,4627,4031,0.47,0.53
36059303700,"Census Tract 3037, Nassau County, New York",6743,4433,2310,0.34,0.66
36059303800,"Census Tract 3038, Nassau County, New York",5005,3434,1571,0.31,0.69
36059303900,"Census Tract 3039, Nassau County, New York",4008,1220,2788,0.7,0.3
36059304001,"Census Tract 3040.01, Nassau County, New York",2621,1831,790,0.3,0.7
36059304002,"Census Tract 3040.02, Nassau County, New York",4729,2250,2479,0.52,0.48
36059304100,"Census Tract 3041, Nassau County, New York",4576,596,3980,0.87,0.13
36059304202,"Census Tract 3042.02, Nassau County, New York",3593,501,3092,0.86,0.14
36059304203,"Census Tract 3042.03, Nassau County, New York",5659,60,5599,0.99,0.01
36059304204,"Census Tract 3042.04, Nassau County, New York",4877,84,4793,0.98,0.02
36059404300,"Census Tract 4043, Nassau County, New York",3502,1497,2005,0.57,0.43
36059404400,"Census Tract 4044, Nassau County, New York",4984,4019,965,0.19,0.81
36059404500,"Census Tract 4045, Nassau County, New York",4321,2839,1482,0.34,0.66
36059404600,"Census Tract 4046, Nassau County, New York",4348,3302,1046,0.24,0.76
36059404700,"Census Tract 4047, Nassau County, New York",6224,3584,2640,0.42,0.58
36059404800,"Census Tract 4048, Nassau County, New York",6782,1154,5628,0.83,0.17
36059404901,"Census Tract 4049.01, Nassau County, New York",5234,199,5035,0.96,0.04
36059404902,"Census Tract 4049.02, Nassau County, New York",4363,327,4036,0.93,0.07
36059405000,"Census Tract 4050, Nassau County, New York",5453,780,4673,0.86,0.14
36059405100,"Census Tract 4051, Nassau County, New York",8317,754,7563,0.91,0.09
36059405200,"Census Tract 4052, Nassau County, New York",6857,1226,5631,0.82,0.18
36059405301,"Census Tract 4053.01, Nassau County, New York",3712,2147,1565,0.42,0.58
36059405302,"Census Tract 4053.02, Nassau County, New York",4295,2760,1535,0.36,0.64
36059405400,"Census Tract 4054, Nassau County, New York",8264,3608,4656,0.56,0.44
36059405500,"Census Tract 4055, Nassau County, New York",5574,3780,1794,0.32,0.68
36059405600,"Census Tract 4056, Nassau County, New York",4163,3163,1000,0.24,0.76
36059405700,"Census Tract 4057, Nassau County, New York",4895,3146,1749,0.36,0.64
36059405800,"Census Tract 4058, Nassau County, New York",4119,3160,959,0.23,0.77
36059405900,"Census Tract 4059, Nassau County, New York",5395,3703,1692,0.31,0.69
36059406001,"Census Tract 4060.01, Nassau County, New York",4761,2807,1954,0.41,0.59
36059406002,"Census Tract 4060.02, Nassau County, New York",3612,2289,1323,0.37,0.63
36059406100,"Census Tract 4061, Nassau County, New York",3006,1696,1310,0.44,0.56
36059406201,"Census Tract 4062.01, Nassau County, New York",3061,827,2234,0.73,0.27
36059406202,"Census Tract 4062.02, Nassau County, New York",6077,152,5925,0.97,0.03
36059406300,"Census Tract 4063, Nassau County, New York",3883,3210,673,0.17,0.83
36059406400,"Census Tract 4064, Nassau County, New York",6948,6045,903,0.13,0.87
36059406501,"Census Tract 4065.01, Nassau County, New York",7110,5799,1311,0.18,0.82
36059406600,"Census Tract 4066, Nassau County, New York",4381,3491,890,0.2,0.8
36059406701,"Census Tract 4067.01, Nassau County, New York",3621,350,3271,0.9,0.1
36059406702,"Census Tract 4067.02, Nassau County, New York",5274,844,4430,0.84,0.16
36059406801,"Census Tract 4068.01, Nassau County, New York",5183,227,4956,0.96,0.04
36059406802,"Census Tract 4068.02, Nassau County, New York",5556,92,5464,0.98,0.02
36059406900,"Census Tract 4069, Nassau County, New York",7949,190,7759,0.98,0.02
36059407000,"Census Tract 4070, Nassau County, New York",8169,123,8046,0.98,0.02
36059407101,"Census Tract 4071.01, Nassau County, New York",5161,162,4999,0.97,0.03
36059407102,"Census Tract 4071.02, Nassau County, New York",5838,214,5624,0.96,0.04
36059407201,"Census Tract 4072.01, Nassau County, New York",5969,234,5735,0.96,0.04
36059407203,"Census Tract 4072.03, Nassau County, New York",3601,166,3435,0.95,0.05
36059407204,"Census Tract 4072.04, Nassau County, New York",2848,465,2383,0.84,0.16
36059407301,"Census Tract 4073.01, Nassau County, New York",6616,3857,2759,0.42,0.58
36059407302,"Census Tract 4073.02, Nassau County, New York",5373,676,4697,0.87,0.13
36059407401,"Census Tract 4074.01, Nassau County, New York",5971,350,5621,0.94,0.06
36059407402,"Census Tract 4074.02, Nassau County, New York",3571,348,3223,0.9,0.1
36059407501,"Census Tract 4075.01, Nassau County, New York",5279,202,5077,0.96,0.04
36059407502,"Census Tract 4075.02, Nassau County, New York",5663,211,5452,0.96,0.04
36059407600,"Census Tract 4076, Nassau County, New York",5623,3071,2552,0.45,0.55
36059407700,"Census Tract 4077, Nassau County, New York",4907,2794,2113,0.43,0.57
36059407801,"Census Tract 4078.01, Nassau County, New York",5531,2995,2536,0.46,0.54
36059407802,"Census Tract 4078.02, Nassau County, New York",1114,506,608,0.55,0.45
36059407900,"Census Tract 4079, Nassau County, New York",5865,3776,2089,0.36,0.64
36059408000,"Census Tract 4080, Nassau County, New York",6490,3703,2787,0.43,0.57
36059408100,"Census Tract 4081, Nassau County, New York",6889,4237,2652,0.38,0.62
36059408200,"Census Tract 4082, Nassau County, New York",6848,3766,3082,0.45,0.55
36059408300,"Census Tract 4083, Nassau County, New York",7147,4185,2962,0.41,0.59
36059408400,"Census Tract 4084, Nassau County, New York",3953,2806,1147,0.29,0.71
36059408500,"Census Tract 4085, Nassau County, New York",6352,4636,1716,0.27,0.73
36059408600,"Census Tract 4086, Nassau County, New York",4456,2679,1777,0.4,0.6
36059408700,"Census Tract 4087, Nassau County, New York",4943,2876,2067,0.42,0.58
36059408800,"Census Tract 4088, Nassau County, New York",6838,4592,2246,0.33,0.67
36059408900,"Census Tract 4089, Nassau County, New York",5784,3556,2228,0.39,0.61
36059409000,"Census Tract 4090, Nassau County, New York",5742,3692,2050,0.36,0.64
36059409100,"Census Tract 4091, Nassau County, New York",5221,3486,1735,0.33,0.67
36059409200,"Census Tract 4092, Nassau County, New York",6055,4062,1993,0.33,0.67
36059409300,"Census Tract 4093, Nassau County, New York",4285,3157,1128,0.26,0.74
36059409400,"Census Tract 4094, Nassau County, New York",4473,3399,1074,0.24,0.76
36059409500,"Census Tract 4095, Nassau County, New York",3961,3354,607,0.15,0.85
36059409600,"Census Tract 4096, Nassau County, New York",5074,3971,1103,0.22,0.78
36059409700,"Census Tract 4097, Nassau County, New York",4258,3510,748,0.18,0.82
36059409800,"Census Tract 4098, Nassau County, New York",5790,304,5486,0.95,0.05
36059409900,"Census Tract 4099, Nassau County, New York",8312,1065,7247,0.87,0.13
36059410000,"Census Tract 4100, Nassau County, New York",4095,1266,2829,0.69,0.31
36059410100,"Census Tract 4101, Nassau County, New York",6011,4452,1559,0.26,0.74
36059410200,"Census Tract 4102, Nassau County, New York",3834,2513,1321,0.34,0.66
36059410300,"Census Tract 4103, Nassau County, New York",6647,1014,5633,0.85,0.15
36059410400,"Census Tract 4104, Nassau County, New York",5647,669,4978,0.88,0.12
36059410500,"Census Tract 4105, Nassau County, New York",7819,1942,5877,0.75,0.25
36059410600,"Census Tract 4106, Nassau County, New York",7741,2700,5041,0.65,0.35
36059410700,"Census Tract 4107, Nassau County, New York",7165,2788,4377,0.61,0.39
36059410800,"Census Tract 4108, Nassau County, New York",5615,2337,3278,0.58,0.42
36059410900,"Census Tract 4109, Nassau County, New York",6386,2125,4261,0.67,0.33
36059411000,"Census Tract 4110, Nassau County, New York",6132,1953,4179,0.68,0.32
36059411100,"Census Tract 4111, Nassau County, New York",5208,727,4481,0.86,0.14
36059411200,"Census Tract 4112, Nassau County, New York",7374,5803,1571,0.21,0.79
36059411301,"Census Tract 4113.01, Nassau County, New York",4329,3414,915,0.21,0.79
36059411302,"Census Tract 4113.02, Nassau County, New York",7369,6678,691,0.09,0.91
36059411400,"Census Tract 4114, Nassau County, New York",6971,5699,1272,0.18,0.82
36059411500,"Census Tract 4115, Nassau County, New York",3250,2826,424,0.13,0.87
36059411600,"Census Tract 4116, Nassau County, New York",6809,6095,714,0.1,0.9
36059411700,"Census Tract 4117, Nassau County, New York",7262,4989,2273,0.31,0.69
36059411800,"Census Tract 4118, Nassau County, New York",6563,4643,1920,0.29,0.71
36059411901,"Census Tract 4119.01, Nassau County, New York",3704,2468,1236,0.33,0.67
36059411902,"Census Tract 4119.02, Nassau County, New York",3746,2363,1383,0.37,0.63
36059412000,"Census Tract 4120, Nassau County, New York",6425,3736,2689,0.42,0.58
36059412100,"Census Tract 4121, Nassau County, New York",6527,5078,1449,0.22,0.78
36059412200,"Census Tract 4122, Nassau County, New York",5749,4477,1272,0.22,0.78
36059412301,"Census Tract 4123.01, Nassau County, New York",3357,2494,863,0.26,0.74
36059412302,"Census Tract 4123.02, Nassau County, New York",3663,2609,1054,0.29,0.71
36059412400,"Census Tract 4124, Nassau County, New York",6179,3918,2261,0.37,0.63
36059412500,"Census Tract 4125, Nassau County, New York",4397,3855,542,0.12,0.88
36059412600,"Census Tract 4126, Nassau County, New York",4305,3781,524,0.12,0.88
36059412700,"Census Tract 4127, Nassau County, New York",4129,3666,463,0.11,0.89
36059412800,"Census Tract 4128, Nassau County, New York",3406,1852,1554,0.46,0.54
36059412900,"Census Tract 4129, Nassau County, New York",6310,660,5650,0.9,0.1
36059413001,"Census Tract 4130.01, Nassau County, New York",4140,3105,1035,0.25,0.75
36059413002,"Census Tract 4130.02, Nassau County, New York",3878,2784,1094,0.28,0.72
36059413100,"Census Tract 4131, Nassau County, New York",4993,3894,1099,0.22,0.78
36059413200,"Census Tract 4132, Nassau County, New York",6668,5116,1552,0.23,0.77
36059413300,"Census Tract 4133, Nassau County, New York",6976,5539,1437,0.21,0.79
36059413400,"Census Tract 4134, Nassau County, New York",5982,4821,1161,0.19,0.81
36059413500,"Census Tract 4135, Nassau County, New York",7583,1952,5631,0.74,0.26
36059413600,"Census Tract 4136, Nassau County, New York",6085,1847,4238,0.7,0.3
36059413700,"Census Tract 4137, Nassau County, New York",5700,2302,3398,0.6,0.4
36059413803,"Census Tract 4138.03, Nassau County, New York",4384,1510,2874,0.66,0.34
36059413804,"Census Tract 4138.04, Nassau County, New York",3857,1560,2297,0.6,0.4
36059413900,"Census Tract 4139, Nassau County, New York",8495,202,8293,0.98,0.02
36059414001,"Census Tract 4140.01, Nassau County, New York",4448,75,4373,0.98,0.02
36059414002,"Census Tract 4140.02, Nassau County, New York",5123,66,5057,0.99,0.01
36059414100,"Census Tract 4141, Nassau County, New York",6832,303,6529,0.96,0.04
36059414201,"Census Tract 4142.01, Nassau County, New York",5440,586,4854,0.89,0.11
36059414202,"Census Tract 4142.02, Nassau County, New York",4694,188,4506,0.96,0.04
36059414301,"Census Tract 4143.01, Nassau County, New York",3825,727,3098,0.81,0.19
36059414303,"Census Tract 4143.03, Nassau County, New York",4640,1080,3560,0.77,0.23
36059414304,"Census Tract 4143.04, Nassau County, New York",3963,362,3601,0.91,0.09
36059414400,"Census Tract 4144, Nassau County, New York",5150,385,4765,0.93,0.07
36059414501,"Census Tract 4145.01, Nassau County, New York",5626,1883,3743,0.67,0.33
36059414502,"Census Tract 4145.02, Nassau County, New York",4302,2118,2184,0.51,0.49
36059414600,"Census Tract 4146, Nassau County, New York",3666,2964,702,0.19,0.81
36059414700,"Census Tract 4147, Nassau County, New York",4619,3796,823,0.18,0.82
36059414800,"Census Tract 4148, Nassau County, New York",6775,5234,1541,0.23,0.77
36059414900,"Census Tract 4149, Nassau County, New York",7456,5573,1883,0.25,0.75
36059415000,"Census Tract 4150, Nassau County, New York",5948,4484,1464,0.25,0.75
36059415101,"Census Tract 4151.01, Nassau County, New York",2790,2232,558,0.2,0.8
36059415102,"Census Tract 4151.02, Nassau County, New York",5122,4399,723,0.14,0.86
36059415201,"Census Tract 4152.01, Nassau County, New York",3676,3031,645,0.18,0.82
36059415202,"Census Tract 4152.02, Nassau County, New York",4504,3928,576,0.13,0.87
36059415300,"Census Tract 4153, Nassau County, New York",5903,4586,1317,0.22,0.78
36059415401,"Census Tract 4154.01, Nassau County, New York",5442,4413,1029,0.19,0.81
36059415402,"Census Tract 4154.02, Nassau County, New York",4952,4238,714,0.14,0.86
36059415500,"Census Tract 4155, Nassau County, New York",2599,2192,407,0.16,0.84
36059415600,"Census Tract 4156, Nassau County, New York",5573,4793,780,0.14,0.86
36059415700,"Census Tract 4157, Nassau County, New York",5932,5141,791,0.13,0.87
36059415802,"Census Tract 4158.02, Nassau County, New York",7108,6277,831,0.12,0.88
36059416000,"Census Tract 4160, Nassau County, New York",4079,3450,629,0.15,0.85
36059416100,"Census Tract 4161, Nassau County, New York",6410,5463,947,0.15,0.85
36059416201,"Census Tract 4162.01, Nassau County, New York",4026,2963,1063,0.26,0.74
36059416202,"Census Tract 4162.02, Nassau County, New York",4928,2729,2199,0.45,0.55
36059416300,"Census Tract 4163, Nassau County, New York",3817,3435,382,0.1,0.9
36059416401,"Census Tract 4164.01, Nassau County, New York",3966,3472,494,0.12,0.88
36059416402,"Census Tract 4164.02, Nassau County, New York",3331,2783,548,0.16,0.84
36059416500,"Census Tract 4165, Nassau County, New York",6465,2330,4135,0.64,0.36
36059416600,"Census Tract 4166, Nassau County, New York",5638,4694,944,0.17,0.83
36059416701,"Census Tract 4167.01, Nassau County, New York",4695,3295,1400,0.3,0.7
36059416702,"Census Tract 4167.02, Nassau County, New York",4458,3495,963,0.22,0.78
36059416801,"Census Tract 4168.01, Nassau County, New York",2197,1900,297,0.14,0.86
36059416802,"Census Tract 4168.02, Nassau County, New York",4279,3562,717,0.17,0.83
36059416900,"Census Tract 4169, Nassau County, New York",4281,3864,417,0.1,0.9
36059517000,"Census Tract 5170, Nassau County, New York",3662,2475,1187,0.32,0.68
36059517101,"Census Tract 5171.01, Nassau County, New York",5560,2512,3048,0.55,0.45
36059517102,"Census Tract 5171.02, Nassau County, New York",2483,1762,721,0.29,0.71
36059517201,"Census Tract 5172.01, Nassau County, New York",4471,1457,3014,0.67,0.33
36059517202,"Census Tract 5172.02, Nassau County, New York",3916,1823,2093,0.53,0.47
36059517301,"Census Tract 5173.01, Nassau County, New York",3090,1759,1331,0.43,0.57
36059517302,"Census Tract 5173.02, Nassau County, New York",5183,2987,2196,0.42,0.58
36059517400,"Census Tract 5174, Nassau County, New York",5062,4160,902,0.18,0.82
36059517500,"Census Tract 5175, Nassau County, New York",3998,3226,772,0.19,0.81
36059517600,"Census Tract 5176, Nassau County, New York",4837,3786,1051,0.22,0.78
36059517701,"Census Tract 5177.01, Nassau County, New York",7679,5179,2500,0.33,0.67
36059517705,"Census Tract 5177.05, Nassau County, New York",2506,1775,731,0.29,0.71
36059517801,"Census Tract 5178.01, Nassau County, New York",3782,3125,657,0.17,0.83
36059517802,"Census Tract 5178.02, Nassau County, New York",3571,2408,1163,0.33,0.67
36059517901,"Census Tract 5179.01, Nassau County, New York",4676,3982,694,0.15,0.85
36059517902,"Census Tract 5179.02, Nassau County, New York",2923,2419,504,0.17,0.83
36059518000,"Census Tract 5180, Nassau County, New York",7075,4997,2078,0.29,0.71
36059518100,"Census Tract 5181, Nassau County, New York",2792,2362,430,0.15,0.85
36059518201,"Census Tract 5182.01, Nassau County, New York",4498,3641,857,0.19,0.81
36059518203,"Census Tract 5182.03, Nassau County, New York",4617,3106,1511,0.33,0.67
36059518204,"Census Tract 5182.04, Nassau County, New York",4718,3775,943,0.2,0.8
36059518300,"Census Tract 5183, Nassau County, New York",5933,3582,2351,0.4,0.6
36059518400,"Census Tract 5184, Nassau County, New York",4254,2394,1860,0.44,0.56
36059518501,"Census Tract 5185.01, Nassau County, New York",7332,3452,3880,0.53,0.47
36059518502,"Census Tract 5185.02, Nassau County, New York",3119,1165,1954,0.63,0.37
36059518600,"Census Tract 5186, Nassau County, New York",4494,1841,2653,0.59,0.41
36059518700,"Census Tract 5187, Nassau County, New York",5733,2868,2865,0.5,0.5
36059518800,"Census Tract 5188, Nassau County, New York",3339,1801,1538,0.46,0.54
36059518900,"Census Tract 5189, Nassau County, New York",7320,2309,5011,0.68,0.32
36059519000,"Census Tract 5190, Nassau County, New York",6500,3135,3365,0.52,0.48
36059519100,"Census Tract 5191, Nassau County, New York",6276,3088,3188,0.51,0.49
36059519200,"Census Tract 5192, Nassau County, New York",6675,2968,3707,0.56,0.44
36059519300,"Census Tract 5193, Nassau County, New York",6613,2153,4460,0.67,0.33
36059519400,"Census Tract 5194, Nassau County, New York",4406,2283,2123,0.48,0.52
36059519500,"Census Tract 5195, Nassau County, New York",6079,3137,2942,0.48,0.52
36059519601,"Census Tract 5196.01, Nassau County, New York",4566,2846,1720,0.38,0.62
36059519602,"Census Tract 5196.02, Nassau County, New York",2168,1611,557,0.26,0.74
36059519702,"Census Tract 5197.02, Nassau County, New York",5663,4544,1119,0.2,0.8
36059519703,"Census Tract 5197.03, Nassau County, New York",3761,2568,1193,0.32,0.68
36059519704,"Census Tract 5197.04, Nassau County, New York",3239,2392,847,0.26,0.74
36059519801,"Census Tract 5198.01, Nassau County, New York",2499,1578,921,0.37,0.63
36059519802,"Census Tract 5198.02, Nassau County, New York",5204,3595,1609,0.31,0.69
36059519900,"Census Tract 5199, Nassau County, New York",5416,4127,1289,0.24,0.76
36059520001,"Census Tract 5200.01, Nassau County, New York",6860,4988,1872,0.27,0.73
36059520002,"Census Tract 5200.02, Nassau County, New York",4382,3177,1205,0.27,0.73
36059520100,"Census Tract 5201, Nassau County, New York",6403,5293,1110,0.17,0.83
36059520200,"Census Tract 5202, Nassau County, New York",3161,2187,974,0.31,0.69
36059520300,"Census Tract 5203, Nassau County, New York",6356,4990,1366,0.21,0.79
36059520401,"Census Tract 5204.01, Nassau County, New York",4256,2970,1286,0.3,0.7
36059520402,"Census Tract 5204.02, Nassau County, New York",4210,3049,1161,0.28,0.72
36059520501,"Census Tract 5205.01, Nassau County, New York",3625,2688,937,0.26,0.74
36059520502,"Census Tract 5205.02, Nassau County, New York",5105,4160,945,0.19,0.81
36059520600,"Census Tract 5206, Nassau County, New York",5615,3974,1641,0.29,0.71
36059520700,"Census Tract 5207, Nassau County, New York",4738,4064,674,0.14,0.86
36059520800,"Census Tract 5208, Nassau County, New York",3898,3340,558,0.14,0.86
36059520900,"Census Tract 5209, Nassau County, New York",4495,3917,578,0.13,0.87
36059521000,"Census Tract 5210, Nassau County, New York",4698,4048,650,0.14,0.86
36059521100,"Census Tract 5211, Nassau County, New York",4459,3811,648,0.15,0.85
36059521200,"Census Tract 5212, Nassau County, New York",2786,2440,346,0.12,0.88
36059521301,"Census Tract 5213.01, Nassau County, New York",2245,1913,332,0.15,0.85
36059521302,"Census Tract 5213.02, Nassau County, New York",5457,4848,609,0.11,0.89
36059521400,"Census Tract 5214, Nassau County, New York",6408,5649,759,0.12,0.88
36059521500,"Census Tract 5215, Nassau County, New York",4865,4252,613,0.13,0.87
36059521601,"Census Tract 5216.01, Nassau County, New York",4213,3750,463,0.11,0.89
36059521602,"Census Tract 5216.02, Nassau County, New York",3327,2974,353,0.11,0.89
36059521700,"Census Tract 5217, Nassau County, New York",4704,4129,575,0.12,0.88
36059521801,"Census Tract 5218.01, Nassau County, New York",3596,2986,610,0.17,0.83
36059521802,"Census Tract 5218.02, Nassau County, New York",3886,3382,504,0.13,0.87
36059521902,"Census Tract 5219.02, Nassau County, New York",4500,4026,474,0.11,0.89
36059522000,"Census Tract 5220, Nassau County, New York",7883,3089,4794,0.61,0.39
36059522700,"Census Tract 5227, Nassau County, New York",4762,4138,624,0.13,0.87
36059980100,"Census Tract 9801, Nassau County, New York",939,795,144,0.15,0.85
36059981100,"Census Tract 9811, Nassau County, New York",995,873,122,0.12,0.88
36059982100,"Census Tract 9821, Nassau County, New York",883,169,714,0.81,0.19
36059990100,"Census Tract 9901, Nassau County, New York",0,0,0,0,0
36059990200,"Census Tract 9902, Nassau County, New York",0,0,0,0,0
36059990301,"Census Tract 9903.01, Nassau County, New York",0,0,0,0,0
36059990302,"Census Tract 9903.02, Nassau County, New York",0,0,0,0,0
36059990400,"Census Tract 9904, Nassau County, New York",0,0,0,0,0
36061000100,"Census Tract 1, New York County, New York",0,0,0,0,0
36061000201,"Census Tract 2.01, New York County, New York",2012,221,1791,0.89,0.11
36061000202,"Census Tract 2.02, New York County, New York",7266,1575,5691,0.78,0.22
36061000500,"Census Tract 5, New York County, New York",5,0,5,1,0
36061000600,"Census Tract 6, New York County, New York",11616,1145,10471,0.9,0.1
36061000700,"Census Tract 7, New York County, New York",10542,6782,3760,0.36,0.64
36061000800,"Census Tract 8, New York County, New York",10871,1233,9638,0.89,0.11
36061000900,"Census Tract 9, New York County, New York",2016,1148,868,0.43,0.57
36061001001,"Census Tract 10.01, New York County, New York",1767,1085,682,0.39,0.61
36061001002,"Census Tract 10.02, New York County, New York",6300,134,6166,0.98,0.02
36061001200,"Census Tract 12, New York County, New York",3776,1705,2071,0.55,0.45
36061001300,"Census Tract 13, New York County, New York",5402,3339,2063,0.38,0.62
36061001401,"Census Tract 14.01, New York County, New York",3543,2080,1463,0.41,0.59
36061001402,"Census Tract 14.02, New York County, New York",3418,957,2461,0.72,0.28
36061001501,"Census Tract 15.01, New York County, New York",8385,4745,3640,0.43,0.57
36061001502,"Census Tract 15.02, New York County, New York",10378,6335,4043,0.39,0.61
36061001600,"Census Tract 16, New York County, New York",7698,1347,6351,0.83,0.17
36061001800,"Census Tract 18, New York County, New York",7934,2551,5383,0.68,0.32
36061002000,"Census Tract 20, New York County, New York",4648,77,4571,0.98,0.02
36061002100,"Census Tract 21, New York County, New York",7811,5223,2588,0.33,0.67
36061002201,"Census Tract 22.01, New York County, New York",6969,1629,5340,0.77,0.23
36061002202,"Census Tract 22.02, New York County, New York",2488,1308,1180,0.47,0.53
36061002400,"Census Tract 24, New York County, New York",4518,81,4437,0.98,0.02
36061002500,"Census Tract 25, New York County, New York",4630,86,4544,0.98,0.02
36061002601,"Census Tract 26.01, New York County, New York",3609,1121,2488,0.69,0.31
36061002602,"Census Tract 26.02, New York County, New York",4816,2406,2410,0.5,0.5
36061002700,"Census Tract 27, New York County, New York",1370,232,1138,0.83,0.17
36061002800,"Census Tract 28, New York County, New York",6819,2164,4655,0.68,0.32
36061002901,"Census Tract 29.01, New York County, New York",1096,228,868,0.79,0.21
36061002902,"Census Tract 29.02, New York County, New York",4359,556,3803,0.87,0.13
36061003001,"Census Tract 30.01, New York County, New York",4663,2575,2088,0.45,0.55
36061003002,"Census Tract 30.02, New York County, New York",3035,1577,1458,0.48,0.52
36061003100,"Census Tract 31, New York County, New York",2989,1270,1719,0.58,0.42
36061003200,"Census Tract 32, New York County, New York",8372,5592,2780,0.33,0.67
36061003300,"Census Tract 33, New York County, New York",6458,4832,1626,0.25,0.75
36061003400,"Census Tract 34, New York County, New York",7012,4459,2553,0.36,0.64
36061003601,"Census Tract 36.01, New York County, New York",3513,1030,2483,0.71,0.29
36061003602,"Census Tract 36.02, New York County, New York",3000,1778,1222,0.41,0.59
36061003700,"Census Tract 37, New York County, New York",3092,2198,894,0.29,0.71
36061003800,"Census Tract 38, New York County, New York",9070,5909,3161,0.35,0.65
36061003900,"Census Tract 39, New York County, New York",7036,5216,1820,0.26,0.74
36061004001,"Census Tract 40.01, New York County, New York",3743,2645,1098,0.29,0.71
36061004002,"Census Tract 40.02, New York County, New York",5090,3149,1941,0.38,0.62
36061004100,"Census Tract 41, New York County, New York",7523,2594,4929,0.66,0.34
36061004200,"Census Tract 42, New York County, New York",5216,2641,2575,0.49,0.51
36061004300,"Census Tract 43, New York County, New York",4158,2556,1602,0.39,0.61
36061004400,"Census Tract 44, New York County, New York",17222,11076,6146,0.36,0.64
36061004500,"Census Tract 45, New York County, New York",1093,688,405,0.37,0.63
36061004700,"Census Tract 47, New York County, New York",2644,1987,657,0.25,0.75
36061004800,"Census Tract 48, New York County, New York",6955,4766,2189,0.31,0.69
36061004900,"Census Tract 49, New York County, New York",4777,3619,1158,0.24,0.76
36061005000,"Census Tract 50, New York County, New York",5223,3935,1288,0.25,0.75
36061005200,"Census Tract 52, New York County, New York",3808,2457,1351,0.35,0.65
36061005400,"Census Tract 54, New York County, New York",4909,3676,1233,0.25,0.75
36061005501,"Census Tract 55.01, New York County, New York",4564,2990,1574,0.34,0.66
36061005502,"Census Tract 55.02, New York County, New York",1956,1483,473,0.24,0.76
36061005600,"Census Tract 56, New York County, New York",4281,2541,1740,0.41,0.59
36061005700,"Census Tract 57, New York County, New York",2998,2388,610,0.2,0.8
36061005800,"Census Tract 58, New York County, New York",5109,3543,1566,0.31,0.69
36061005900,"Census Tract 59, New York County, New York",5707,4259,1448,0.25,0.75
36061006000,"Census Tract 60, New York County, New York",5290,3682,1608,0.3,0.7
36061006100,"Census Tract 61, New York County, New York",5494,3542,1952,0.36,0.64
36061006200,"Census Tract 62, New York County, New York",3686,1646,2040,0.55,0.45
36061006300,"Census Tract 63, New York County, New York",6707,5319,1388,0.21,0.79
36061006400,"Census Tract 64, New York County, New York",8744,5815,2929,0.33,0.67
36061006500,"Census Tract 65, New York County, New York",6721,4737,1984,0.3,0.7
36061006600,"Census Tract 66, New York County, New York",12341,6310,6031,0.49,0.51
36061006700,"Census Tract 67, New York County, New York",5547,4397,1150,0.21,0.79
36061006800,"Census Tract 68, New York County, New York",7706,4983,2723,0.35,0.65
36061006900,"Census Tract 69, New York County, New York",2799,2073,726,0.26,0.74
36061007001,"Census Tract 70.01, New York County, New York",4550,2943,1607,0.35,0.65
36061007002,"Census Tract 70.02, New York County, New York",4865,3408,1457,0.3,0.7
36061007100,"Census Tract 71, New York County, New York",5851,4501,1350,0.23,0.77
36061007200,"Census Tract 72, New York County, New York",9358,6451,2907,0.31,0.69
36061007300,"Census Tract 73, New York County, New York",6180,4962,1218,0.2,0.8
36061007400,"Census Tract 74, New York County, New York",5698,3637,2061,0.36,0.64
36061007500,"Census Tract 75, New York County, New York",4000,3231,769,0.19,0.81
36061007600,"Census Tract 76, New York County, New York",2921,1125,1796,0.61,0.39
36061007700,"Census Tract 77, New York County, New York",6192,4898,1294,0.21,0.79
36061007800,"Census Tract 78, New York County, New York",9109,5421,3688,0.4,0.6
36061007900,"Census Tract 79, New York County, New York",4442,3546,896,0.2,0.8
36061008000,"Census Tract 80, New York County, New York",5906,4062,1844,0.31,0.69
36061008100,"Census Tract 81, New York County, New York",7853,5517,2336,0.3,0.7
36061008200,"Census Tract 82, New York County, New York",3414,2230,1184,0.35,0.65
36061008300,"Census Tract 83, New York County, New York",3853,1682,2171,0.56,0.44
36061008400,"Census Tract 84, New York County, New York",1985,736,1249,0.63,0.37
36061008601,"Census Tract 86.01, New York County, New York",4853,2441,2412,0.5,0.5
36061008602,"Census Tract 86.02, New York County, New York",0,0,0,0,0
36061008603,"Census Tract 86.03, New York County, New York",5347,4178,1169,0.22,0.78
36061008700,"Census Tract 87, New York County, New York",6510,4565,1945,0.3,0.7
36061008800,"Census Tract 88, New York County, New York",8852,5305,3547,0.4,0.6
36061008900,"Census Tract 89, New York County, New York",5957,3787,2170,0.36,0.64
36061009000,"Census Tract 90, New York County, New York",8830,5226,3604,0.41,0.59
36061009100,"Census Tract 91, New York County, New York",7362,4859,2503,0.34,0.66
36061009200,"Census Tract 92, New York County, New York",1866,1048,818,0.44,0.56
36061009300,"Census Tract 93, New York County, New York",9325,5696,3629,0.39,0.61
36061009400,"Census Tract 94, New York County, New York",109,55,54,0.5,0.5
36061009500,"Census Tract 95, New York County, New York",3892,1735,2157,0.55,0.45
36061009600,"Census Tract 96, New York County, New York",608,122,486,0.8,0.2
36061009700,"Census Tract 97, New York County, New York",5071,2231,2840,0.56,0.44
36061009800,"Census Tract 98, New York County, New York",8078,5413,2665,0.33,0.67
36061009901,"Census Tract 99.01, New York County, New York",2093,1406,687,0.33,0.67
36061009902,"Census Tract 99.02, New York County, New York",3848,2184,1664,0.43,0.57
36061009903,"Census Tract 99.03, New York County, New York",2380,959,1421,0.6,0.4
36061010000,"Census Tract 100, New York County, New York",2170,1291,879,0.41,0.59
36061010100,"Census Tract 101, New York County, New York",2596,832,1764,0.68,0.32
36061010200,"Census Tract 102, New York County, New York",283,204,79,0.28,0.72
36061010300,"Census Tract 103, New York County, New York",4095,1438,2657,0.65,0.35
36061010400,"Census Tract 104, New York County, New York",983,643,340,0.35,0.65
36061010601,"Census Tract 106.01, New York County, New York",8256,6989,1267,0.15,0.85
36061010602,"Census Tract 106.02, New York County, New York",5489,3500,1989,0.36,0.64
36061010801,"Census Tract 108.01, New York County, New York",3297,2307,990,0.3,0.7
36061010802,"Census Tract 108.02, New York County, New York",3805,2889,916,0.24,0.76
36061010803,"Census Tract 108.03, New York County, New York",2696,1888,808,0.3,0.7
36061010900,"Census Tract 109, New York County, New York",407,134,273,0.67,0.33
36061011000,"Census Tract 110, New York County, New York",7671,5492,2179,0.28,0.72
36061011100,"Census Tract 111, New York County, New York",6138,2362,3776,0.62,0.38
36061011201,"Census Tract 112.01, New York County, New York",1233,891,342,0.28,0.72
36061011202,"Census Tract 112.02, New York County, New York",500,370,130,0.26,0.74
36061011203,"Census Tract 112.03, New York County, New York",1420,961,459,0.32,0.68
36061011300,"Census Tract 113, New York County, New York",216,78,138,0.64,0.36
36061011401,"Census Tract 114.01, New York County, New York",1361,1076,285,0.21,0.79
36061011402,"Census Tract 114.02, New York County, New York",2620,2050,570,0.22,0.78
36061011500,"Census Tract 115, New York County, New York",3863,1386,2477,0.64,0.36
36061011600,"Census Tract 116, New York County, New York",3263,2177,1086,0.33,0.67
36061011700,"Census Tract 117, New York County, New York",5256,2149,3107,0.59,0.41
36061011800,"Census Tract 118, New York County, New York",9688,7729,1959,0.2,0.8
36061011900,"Census Tract 119, New York County, New York",1666,389,1277,0.77,0.23
36061012000,"Census Tract 120, New York County, New York",3905,3288,617,0.16,0.84
36061012101,"Census Tract 121.01, New York County, New York",3408,1575,1833,0.54,0.46
36061012102,"Census Tract 121.02, New York County, New York",5236,3325,1911,0.36,0.64
36061012200,"Census Tract 122, New York County, New York",3425,2930,495,0.14,0.86
36061012400,"Census Tract 124, New York County, New York",10845,7749,3096,0.29,0.71
36061012500,"Census Tract 125, New York County, New York",2901,1015,1886,0.65,0.35
36061012601,"Census Tract 126.01, New York County, New York",7437,5797,1640,0.22,0.78
36061012602,"Census Tract 126.02, New York County, New York",6400,5292,1108,0.17,0.83
36061012700,"Census Tract 127, New York County, New York",7282,3933,3349,0.46,0.54
36061012800,"Census Tract 128, New York County, New York",6545,5623,922,0.14,0.86
36061012901,"Census Tract 129.01, New York County, New York",7959,3378,4581,0.58,0.42
36061012902,"Census Tract 129.02, New York County, New York",3144,1491,1653,0.53,0.47
36061013000,"Census Tract 130, New York County, New York",3911,3388,523,0.13,0.87
36061013100,"Census Tract 131, New York County, New York",3962,1862,2100,0.53,0.47
36061013201,"Census Tract 132.01, New York County, New York",3146,2313,833,0.26,0.74
36061013202,"Census Tract 132.02, New York County, New York",4237,3029,1208,0.29,0.71
36061013203,"Census Tract 132.03, New York County, New York",3747,2739,1008,0.27,0.73
36061013300,"Census Tract 133, New York County, New York",6782,3511,3271,0.48,0.52
36061013400,"Census Tract 134, New York County, New York",11882,9155,2727,0.23,0.77
36061013501,"Census Tract 135.01, New York County, New York",5504,2281,3223,0.59,0.41
36061013502,"Census Tract 135.02, New York County, New York",6358,2484,3874,0.61,0.39
36061013601,"Census Tract 136.01, New York County, New York",1962,1700,262,0.13,0.87
36061013602,"Census Tract 136.02, New York County, New York",5070,3845,1225,0.24,0.76
36061013603,"Census Tract 136.03, New York County, New York",4387,3474,913,0.21,0.79
36061013604,"Census Tract 136.04, New York County, New York",5057,3800,1257,0.25,0.75
36061013700,"Census Tract 137, New York County, New York",7308,4646,2662,0.36,0.64
36061013800,"Census Tract 138, New York County, New York",13109,9967,3142,0.24,0.76
36061013900,"Census Tract 139, New York County, New York",9988,6091,3897,0.39,0.61
36061014000,"Census Tract 140, New York County, New York",8050,6601,1449,0.18,0.82
36061014200,"Census Tract 142, New York County, New York",4463,3842,621,0.14,0.86
36061014300,"Census Tract 143, New York County, New York",129,32,97,0.75,0.25
36061014401,"Census Tract 144.01, New York County, New York",5040,3994,1046,0.21,0.79
36061014402,"Census Tract 144.02, New York County, New York",7151,5446,1705,0.24,0.76
36061014500,"Census Tract 145, New York County, New York",7532,4628,2904,0.39,0.61
36061014601,"Census Tract 146.01, New York County, New York",4481,3230,1251,0.28,0.72
36061014602,"Census Tract 146.02, New York County, New York",9061,6687,2374,0.26,0.74
36061014700,"Census Tract 147, New York County, New York",2987,1643,1344,0.45,0.55
36061014801,"Census Tract 148.01, New York County, New York",3221,2485,736,0.23,0.77
36061014802,"Census Tract 148.02, New York County, New York",7494,5889,1605,0.21,0.79
36061014900,"Census Tract 149, New York County, New York",6351,4817,1534,0.24,0.76
36061015001,"Census Tract 150.01, New York County, New York",2321,1968,353,0.15,0.85
36061015002,"Census Tract 150.02, New York County, New York",5642,4862,780,0.14,0.86
36061015101,"Census Tract 151.01, New York County, New York",3756,468,3288,0.88,0.12
36061015102,"Census Tract 151.02, New York County, New York",8254,4036,4218,0.51,0.49
36061015200,"Census Tract 152, New York County, New York",7730,4107,3623,0.47,0.53
36061015301,"Census Tract 153.01, New York County, New York",3684,2949,735,0.2,0.8
36061015302,"Census Tract 153.02, New York County, New York",6032,4416,1616,0.27,0.73
36061015401,"Census Tract 154.01, New York County, New York",5189,3636,1553,0.3,0.7
36061015402,"Census Tract 154.02, New York County, New York",4503,3025,1478,0.33,0.67
36061015403,"Census Tract 154.03, New York County, New York",5738,3348,2390,0.42,0.58
36061015501,"Census Tract 155.01, New York County, New York",5091,3875,1216,0.24,0.76
36061015502,"Census Tract 155.02, New York County, New York",5759,4122,1637,0.28,0.72
36061015601,"Census Tract 156.01, New York County, New York",5568,3371,2197,0.39,0.61
36061015602,"Census Tract 156.02, New York County, New York",2154,661,1493,0.69,0.31
36061015700,"Census Tract 157, New York County, New York",11197,8492,2705,0.24,0.76
36061015801,"Census Tract 158.01, New York County, New York",5600,4278,1322,0.24,0.76
36061015802,"Census Tract 158.02, New York County, New York",4516,2443,2073,0.46,0.54
36061015900,"Census Tract 159, New York County, New York",10054,7555,2499,0.25,0.75
36061016001,"Census Tract 160.01, New York County, New York",3852,3273,579,0.15,0.85
36061016002,"Census Tract 160.02, New York County, New York",3607,2288,1319,0.37,0.63
36061016100,"Census Tract 161, New York County, New York",6617,5116,1501,0.23,0.77
36061016200,"Census Tract 162, New York County, New York",9033,585,8448,0.94,0.06
36061016300,"Census Tract 163, New York County, New York",7292,5282,2010,0.28,0.72
36061016400,"Census Tract 164, New York County, New York",7371,831,6540,0.89,0.11
36061016500,"Census Tract 165, New York County, New York",6659,5151,1508,0.23,0.77
36061016600,"Census Tract 166, New York County, New York",7012,1453,5559,0.79,0.21
36061016700,"Census Tract 167, New York County, New York",7210,5546,1664,0.23,0.77
36061016800,"Census Tract 168, New York County, New York",4964,926,4038,0.81,0.19
36061016900,"Census Tract 169, New York County, New York",8526,6244,2282,0.27,0.73
36061017000,"Census Tract 170, New York County, New York",7991,870,7121,0.89,0.11
36061017100,"Census Tract 171, New York County, New York",9694,7188,2506,0.26,0.74
36061017200,"Census Tract 172, New York County, New York",5441,755,4686,0.86,0.14
36061017300,"Census Tract 173, New York County, New York",8699,5779,2920,0.34,0.66
36061017401,"Census Tract 174.01, New York County, New York",5449,717,4732,0.87,0.13
36061017402,"Census Tract 174.02, New York County, New York",2276,435,1841,0.81,0.19
36061017500,"Census Tract 175, New York County, New York",11110,8126,2984,0.27,0.73
36061017700,"Census Tract 177, New York County, New York",9382,4755,4627,0.49,0.51
36061017800,"Census Tract 178, New York County, New York",3860,818,3042,0.79,0.21
36061017900,"Census Tract 179, New York County, New York",9103,6057,3046,0.33,0.67
36061018000,"Census Tract 180, New York County, New York",7429,779,6650,0.9,0.1
36061018100,"Census Tract 181, New York County, New York",8941,5108,3833,0.43,0.57
36061018200,"Census Tract 182, New York County, New York",7675,754,6921,0.9,0.1
36061018300,"Census Tract 183, New York County, New York",8534,5494,3040,0.36,0.64
36061018400,"Census Tract 184, New York County, New York",7820,680,7140,0.91,0.09
36061018500,"Census Tract 185, New York County, New York",5243,3072,2171,0.41,0.59
36061018600,"Census Tract 186, New York County, New York",5127,348,4779,0.93,0.07
36061018700,"Census Tract 187, New York County, New York",9383,5752,3631,0.39,0.61
36061018800,"Census Tract 188, New York County, New York",5697,856,4841,0.85,0.15
36061018900,"Census Tract 189, New York County, New York",11556,3061,8495,0.74,0.26
36061019000,"Census Tract 190, New York County, New York",3679,756,2923,0.79,0.21
36061019100,"Census Tract 191, New York County, New York",9005,5528,3477,0.39,0.61
36061019200,"Census Tract 192, New York County, New York",3971,187,3784,0.95,0.05
36061019300,"Census Tract 193, New York County, New York",8736,2473,6263,0.72,0.28
36061019400,"Census Tract 194, New York County, New York",6978,578,6400,0.92,0.08
36061019500,"Census Tract 195, New York County, New York",7828,4453,3375,0.43,0.57
36061019600,"Census Tract 196, New York County, New York",4031,554,3477,0.86,0.14
36061019701,"Census Tract 197.01, New York County, New York",1278,385,893,0.7,0.3
36061019702,"Census Tract 197.02, New York County, New York",2601,914,1687,0.65,0.35
36061019800,"Census Tract 198, New York County, New York",2370,561,1809,0.76,0.24
36061019900,"Census Tract 199, New York County, New York",9598,4967,4631,0.48,0.52
36061020000,"Census Tract 200, New York County, New York",2855,859,1996,0.7,0.3
36061020101,"Census Tract 201.01, New York County, New York",1863,839,1024,0.55,0.45
36061020102,"Census Tract 201.02, New York County, New York",4077,1173,2904,0.71,0.29
36061020300,"Census Tract 203, New York County, New York",3874,1427,2447,0.63,0.37
36061020500,"Census Tract 205, New York County, New York",5023,2991,2032,0.4,0.6
36061020600,"Census Tract 206, New York County, New York",3628,613,3015,0.83,0.17
36061020701,"Census Tract 207.01, New York County, New York",3035,1466,1569,0.52,0.48
36061020800,"Census Tract 208, New York County, New York",5255,1001,4254,0.81,0.19
36061020901,"Census Tract 209.01, New York County, New York",3665,267,3398,0.93,0.07
36061021000,"Census Tract 210, New York County, New York",6748,162,6586,0.98,0.02
36061021100,"Census Tract 211, New York County, New York",10529,3340,7189,0.68,0.32
36061021200,"Census Tract 212, New York County, New York",4899,611,4288,0.88,0.12
36061021303,"Census Tract 213.03, New York County, New York",5583,1171,4412,0.79,0.21
36061021400,"Census Tract 214, New York County, New York",3075,312,2763,0.9,0.1
36061021500,"Census Tract 215, New York County, New York",3856,434,3422,0.89,0.11
36061021600,"Census Tract 216, New York County, New York",8567,2073,6494,0.76,0.24
36061021703,"Census Tract 217.03, New York County, New York",545,202,343,0.63,0.37
36061021800,"Census Tract 218, New York County, New York",6530,1365,5165,0.79,0.21
36061021900,"Census Tract 219, New York County, New York",5696,278,5418,0.95,0.05
36061022000,"Census Tract 220, New York County, New York",6114,1457,4657,0.76,0.24
36061022102,"Census Tract 221.02, New York County, New York",2382,570,1812,0.76,0.24
36061022200,"Census Tract 222, New York County, New York",3293,829,2464,0.75,0.25
36061022301,"Census Tract 223.01, New York County, New York",7258,1104,6154,0.85,0.15
36061022302,"Census Tract 223.02, New York County, New York",3101,432,2669,0.86,0.14
36061022400,"Census Tract 224, New York County, New York",7346,637,6709,0.91,0.09
36061022500,"Census Tract 225, New York County, New York",9895,1498,8397,0.85,0.15
36061022600,"Census Tract 226, New York County, New York",4890,803,4087,0.84,0.16
36061022700,"Census Tract 227, New York County, New York",5387,1296,4091,0.76,0.24
36061022800,"Census Tract 228, New York County, New York",5961,915,5046,0.85,0.15
36061022900,"Census Tract 229, New York County, New York",7975,1307,6668,0.84,0.16
36061023000,"Census Tract 230, New York County, New York",9111,924,8187,0.9,0.1
36061023100,"Census Tract 231, New York County, New York",6273,1397,4876,0.78,0.22
36061023200,"Census Tract 232, New York County, New York",8061,396,7665,0.95,0.05
36061023300,"Census Tract 233, New York County, New York",6368,1517,4851,0.76,0.24
36061023400,"Census Tract 234, New York County, New York",5112,761,4351,0.85,0.15
36061023501,"Census Tract 235.01, New York County, New York",6720,1191,5529,0.82,0.18
36061023502,"Census Tract 235.02, New York County, New York",2206,235,1971,0.89,0.11
36061023600,"Census Tract 236, New York County, New York",9907,265,9642,0.97,0.03
36061023700,"Census Tract 237, New York County, New York",6792,1215,5577,0.82,0.18
36061023802,"Census Tract 238.02, New York County, New York",4791,1512,3279,0.68,0.32
36061023803,"Census Tract 238.03, New York County, New York",3625,1425,2200,0.61,0.39
36061023804,"Census Tract 238.04, New York County, New York",3306,1314,1992,0.6,0.4
36061023900,"Census Tract 239, New York County, New York",2675,417,2258,0.84,0.16
36061024000,"Census Tract 240, New York County, New York",1302,170,1132,0.87,0.13
36061024100,"Census Tract 241, New York County, New York",7612,1649,5963,0.78,0.22
36061024200,"Census Tract 242, New York County, New York",4448,189,4259,0.96,0.04
36061024301,"Census Tract 243.01, New York County, New York",3993,629,3364,0.84,0.16
36061024302,"Census Tract 243.02, New York County, New York",7237,81,7156,0.99,0.01
36061024500,"Census Tract 245, New York County, New York",13385,1678,11707,0.87,0.13
36061024700,"Census Tract 247, New York County, New York",6521,1241,5280,0.81,0.19
36061024900,"Census Tract 249, New York County, New York",1084,158,926,0.85,0.15
36061025100,"Census Tract 251, New York County, New York",2287,240,2047,0.9,0.1
36061025300,"Census Tract 253, New York County, New York",10081,1584,8497,0.84,0.16
36061025500,"Census Tract 255, New York County, New York",5697,1805,3892,0.68,0.32
36061025700,"Census Tract 257, New York County, New York",4270,1348,2922,0.68,0.32
36061025900,"Census Tract 259, New York County, New York",4029,711,3318,0.82,0.18
36061026100,"Census Tract 261, New York County, New York",10733,559,10174,0.95,0.05
36061026300,"Census Tract 263, New York County, New York",7969,926,7043,0.88,0.12
36061026500,"Census Tract 265, New York County, New York",6850,2111,4739,0.69,0.31
36061026700,"Census Tract 267, New York County, New York",2083,1135,948,0.46,0.54
36061026900,"Census Tract 269, New York County, New York",7848,777,7071,0.9,0.1
36061027100,"Census Tract 271, New York County, New York",7623,2020,5603,0.74,0.26
36061027300,"Census Tract 273, New York County, New York",6519,4029,2490,0.38,0.62
36061027500,"Census Tract 275, New York County, New York",3063,2075,988,0.32,0.68
36061027700,"Census Tract 277, New York County, New York",6423,658,5765,0.9,0.1
36061027900,"Census Tract 279, New York County, New York",10019,2066,7953,0.79,0.21
36061028100,"Census Tract 281, New York County, New York",3108,2107,1001,0.32,0.68
36061028300,"Census Tract 283, New York County, New York",7740,1466,6274,0.81,0.19
36061028500,"Census Tract 285, New York County, New York",6794,676,6118,0.9,0.1
36061028700,"Census Tract 287, New York County, New York",3772,1149,2623,0.7,0.3
36061029100,"Census Tract 291, New York County, New York",10509,796,9713,0.92,0.08
36061029300,"Census Tract 293, New York County, New York",8035,604,7431,0.92,0.08
36061029500,"Census Tract 295, New York County, New York",7039,2362,4677,0.66,0.34
36061029700,"Census Tract 297, New York County, New York",16,0,16,1,0
36061029900,"Census Tract 299, New York County, New York",3598,78,3520,0.98,0.02
36061030300,"Census Tract 303, New York County, New York",3691,1331,2360,0.64,0.36
36061030700,"Census Tract 307, New York County, New York",3427,1896,1531,0.45,0.55
36061030900,"Census Tract 309, New York County, New York",8594,547,8047,0.94,0.06
36061031100,"Census Tract 311, New York County, New York",12,0,12,1,0
36061031703,"Census Tract 317.03, New York County, New York",5847,3840,2007,0.34,0.66
36061031704,"Census Tract 317.04, New York County, New York",10422,6349,4073,0.39,0.61
36061031900,"Census Tract 319, New York County, New York",3,0,3,1,0
36063020100,"Census Tract 201, Niagara County, New York",3333,2609,724,0.22,0.78
36063020200,"Census Tract 202, Niagara County, New York",2811,293,2518,0.9,0.1
36063020300,"Census Tract 203, Niagara County, New York",2288,1442,846,0.37,0.63
36063020400,"Census Tract 204, Niagara County, New York",1492,550,942,0.63,0.37
36063020500,"Census Tract 205, Niagara County, New York",2065,973,1092,0.53,0.47
36063020600,"Census Tract 206, Niagara County, New York",1276,370,906,0.71,0.29
36063020700,"Census Tract 207, Niagara County, New York",2650,1279,1371,0.52,0.48
36063020900,"Census Tract 209, Niagara County, New York",2442,986,1456,0.6,0.4
36063021000,"Census Tract 210, Niagara County, New York",2778,1674,1104,0.4,0.6
36063021100,"Census Tract 211, Niagara County, New York",1444,613,831,0.58,0.42
36063021200,"Census Tract 212, Niagara County, New York",2310,969,1341,0.58,0.42
36063021300,"Census Tract 213, Niagara County, New York",2224,995,1229,0.55,0.45
36063021400,"Census Tract 214, Niagara County, New York",2113,1297,816,0.39,0.61
36063021700,"Census Tract 217, Niagara County, New York",3358,1815,1543,0.46,0.54
36063022000,"Census Tract 220, Niagara County, New York",3272,2567,705,0.22,0.78
36063022100,"Census Tract 221, Niagara County, New York",2201,1841,360,0.16,0.84
36063022200,"Census Tract 222, Niagara County, New York",3549,3012,537,0.15,0.85
36063022300,"Census Tract 223, Niagara County, New York",2440,2015,425,0.17,0.83
36063022401,"Census Tract 224.01, Niagara County, New York",1817,1544,273,0.15,0.85
36063022500,"Census Tract 225, Niagara County, New York",2808,2266,542,0.19,0.81
36063022601,"Census Tract 226.01, Niagara County, New York",2194,1882,312,0.14,0.86
36063022602,"Census Tract 226.02, Niagara County, New York",5709,4712,997,0.17,0.83
36063022702,"Census Tract 227.02, Niagara County, New York",7035,6587,448,0.06,0.94
36063022713,"Census Tract 227.13, Niagara County, New York",3229,2953,276,0.09,0.91
36063022714,"Census Tract 227.14, Niagara County, New York",4854,4232,622,0.13,0.87
36063022715,"Census Tract 227.15, Niagara County, New York",1865,1699,166,0.09,0.91
36063022716,"Census Tract 227.16, Niagara County, New York",3609,3177,432,0.12,0.88
36063022717,"Census Tract 227.17, Niagara County, New York",5074,4731,343,0.07,0.93
36063022803,"Census Tract 228.03, Niagara County, New York",3499,3281,218,0.06,0.94
36063022804,"Census Tract 228.04, Niagara County, New York",3155,2930,225,0.07,0.93
36063022901,"Census Tract 229.01, Niagara County, New York",2256,2059,197,0.09,0.91
36063022902,"Census Tract 229.02, Niagara County, New York",2892,2673,219,0.08,0.92
36063023001,"Census Tract 230.01, Niagara County, New York",2208,1932,276,0.13,0.88
36063023100,"Census Tract 231, Niagara County, New York",2372,2064,308,0.13,0.87
36063023200,"Census Tract 232, Niagara County, New York",2849,2516,333,0.12,0.88
36063023301,"Census Tract 233.01, Niagara County, New York",2941,2748,193,0.07,0.93
36063023302,"Census Tract 233.02, Niagara County, New York",3824,3307,517,0.14,0.86
36063023401,"Census Tract 234.01, Niagara County, New York",6903,5772,1131,0.16,0.84
36063023402,"Census Tract 234.02, Niagara County, New York",4211,3813,398,0.09,0.91
36063023404,"Census Tract 234.04, Niagara County, New York",5174,4423,751,0.15,0.85
36063023405,"Census Tract 234.05, Niagara County, New York",4275,3498,777,0.18,0.82
36063023500,"Census Tract 235, Niagara County, New York",2725,2100,625,0.23,0.77
36063023600,"Census Tract 236, Niagara County, New York",3803,2841,962,0.25,0.75
36063023700,"Census Tract 237, Niagara County, New York",2116,1424,692,0.33,0.67
36063023800,"Census Tract 238, Niagara County, New York",3306,2523,783,0.24,0.76
36063023901,"Census Tract 239.01, Niagara County, New York",3923,3282,641,0.16,0.84
36063023902,"Census Tract 239.02, Niagara County, New York",5003,4374,629,0.13,0.87
36063024001,"Census Tract 240.01, Niagara County, New York",5962,5558,404,0.07,0.93
36063024002,"Census Tract 240.02, Niagara County, New York",1729,1568,161,0.09,0.91
36063024101,"Census Tract 241.01, Niagara County, New York",3700,3416,284,0.08,0.92
36063024102,"Census Tract 241.02, Niagara County, New York",2597,2311,286,0.11,0.89
36063024201,"Census Tract 242.01, Niagara County, New York",6609,6124,485,0.07,0.93
36063024202,"Census Tract 242.02, Niagara County, New York",2695,2435,260,0.1,0.9
36063024301,"Census Tract 243.01, Niagara County, New York",1247,1180,67,0.05,0.95
36063024302,"Census Tract 243.02, Niagara County, New York",4600,4198,402,0.09,0.91
36063024303,"Census Tract 243.03, Niagara County, New York",5743,5259,484,0.08,0.92
36063024401,"Census Tract 244.01, Niagara County, New York",2531,2304,227,0.09,0.91
36063024404,"Census Tract 244.04, Niagara County, New York",4775,4415,360,0.08,0.92
36063024405,"Census Tract 244.05, Niagara County, New York",5510,5063,447,0.08,0.92
36063024406,"Census Tract 244.06, Niagara County, New York",3128,2676,452,0.14,0.86
36063024501,"Census Tract 245.01, Niagara County, New York",2741,2532,209,0.08,0.92
36063024502,"Census Tract 245.02, Niagara County, New York",3772,3457,315,0.08,0.92
36063024600,"Census Tract 246, Niagara County, New York",4507,4148,359,0.08,0.92
36063940001,"Census Tract 9400.01, Niagara County, New York",1145,404,741,0.65,0.35
36063940100,"Census Tract 9401, Niagara County, New York",0,0,0,0,0
36063990000,"Census Tract 9900, Niagara County, New York",0,0,0,0,0
36065020102,"Census Tract 201.02, Oneida County, New York",1359,767,592,0.44,0.56
36065020300,"Census Tract 203, Oneida County, New York",1477,634,843,0.57,0.43
36065020705,"Census Tract 207.05, Oneida County, New York",2074,1330,744,0.36,0.64
36065020802,"Census Tract 208.02, Oneida County, New York",4637,2056,2581,0.56,0.44
36065020803,"Census Tract 208.03, Oneida County, New York",2731,882,1849,0.68,0.32
36065020900,"Census Tract 209, Oneida County, New York",2171,866,1305,0.6,0.4
36065021000,"Census Tract 210, Oneida County, New York",1872,729,1143,0.61,0.39
36065021103,"Census Tract 211.03, Oneida County, New York",1540,806,734,0.48,0.52
36065021104,"Census Tract 211.04, Oneida County, New York",4114,1754,2360,0.57,0.43
36065021201,"Census Tract 212.01, Oneida County, New York",2302,491,1811,0.79,0.21
36065021202,"Census Tract 212.02, Oneida County, New York",3271,882,2389,0.73,0.27
36065021301,"Census Tract 213.01, Oneida County, New York",1401,1265,136,0.1,0.9
36065021302,"Census Tract 213.02, Oneida County, New York",4807,3057,1750,0.36,0.64
36065021303,"Census Tract 213.03, Oneida County, New York",3956,2610,1346,0.34,0.66
36065021401,"Census Tract 214.01, Oneida County, New York",2664,1461,1203,0.45,0.55
36065021402,"Census Tract 214.02, Oneida County, New York",2028,1120,908,0.45,0.55
36065021500,"Census Tract 215, Oneida County, New York",2768,362,2406,0.87,0.13
36065021601,"Census Tract 216.01, Oneida County, New York",5116,4045,1071,0.21,0.79
36065021602,"Census Tract 216.02, Oneida County, New York",2438,2188,250,0.1,0.9
36065021701,"Census Tract 217.01, Oneida County, New York",3205,2842,363,0.11,0.89
36065021702,"Census Tract 217.02, Oneida County, New York",2741,1949,792,0.29,0.71
36065021900,"Census Tract 219, Oneida County, New York",1694,1281,413,0.24,0.76
36065022000,"Census Tract 220, Oneida County, New York",3438,2585,853,0.25,0.75
36065022100,"Census Tract 221, Oneida County, New York",2537,2059,478,0.19,0.81
36065022200,"Census Tract 222, Oneida County, New York",2648,2361,287,0.11,0.89
36065022400,"Census Tract 224, Oneida County, New York",3397,2795,602,0.18,0.82
36065022500,"Census Tract 225, Oneida County, New York",4742,3479,1263,0.27,0.73
36065022701,"Census Tract 227.01, Oneida County, New York",2046,1778,268,0.13,0.87
36065022702,"Census Tract 227.02, Oneida County, New York",3882,3450,432,0.11,0.89
36065022800,"Census Tract 228, Oneida County, New York",2690,2444,246,0.09,0.91
36065023000,"Census Tract 230, Oneida County, New York",5924,5487,437,0.07,0.93
36065023200,"Census Tract 232, Oneida County, New York",4230,3666,564,0.13,0.87
36065023300,"Census Tract 233, Oneida County, New York",2657,2248,409,0.15,0.85
36065023400,"Census Tract 234, Oneida County, New York",4503,3954,549,0.12,0.88
36065023501,"Census Tract 235.01, Oneida County, New York",2290,2142,148,0.06,0.94
36065023502,"Census Tract 235.02, Oneida County, New York",4338,4096,242,0.06,0.94
36065023702,"Census Tract 237.02, Oneida County, New York",3733,3446,287,0.08,0.92
36065023901,"Census Tract 239.01, Oneida County, New York",2187,2037,150,0.07,0.93
36065023902,"Census Tract 239.02, Oneida County, New York",1796,1684,112,0.06,0.94
36065024000,"Census Tract 240, Oneida County, New York",4297,4033,264,0.06,0.94
36065024101,"Census Tract 241.01, Oneida County, New York",1477,1422,55,0.04,0.96
36065024102,"Census Tract 241.02, Oneida County, New York",2842,2679,163,0.06,0.94
36065024200,"Census Tract 242, Oneida County, New York",4518,4254,264,0.06,0.94
36065024301,"Census Tract 243.01, Oneida County, New York",2782,2556,226,0.08,0.92
36065024302,"Census Tract 243.02, Oneida County, New York",3389,3150,239,0.07,0.93
36065024303,"Census Tract 243.03, Oneida County, New York",2511,2373,138,0.05,0.95
36065024400,"Census Tract 244, Oneida County, New York",3923,3519,404,0.1,0.9
36065024500,"Census Tract 245, Oneida County, New York",4787,4440,347,0.07,0.93
36065024700,"Census Tract 247, Oneida County, New York",5974,5545,429,0.07,0.93
36065024800,"Census Tract 248, Oneida County, New York",3077,2846,231,0.08,0.92
36065024900,"Census Tract 249, Oneida County, New York",5241,4861,380,0.07,0.93
36065025001,"Census Tract 250.01, Oneida County, New York",3230,2927,303,0.09,0.91
36065025002,"Census Tract 250.02, Oneida County, New York",3730,3403,327,0.09,0.91
36065025003,"Census Tract 250.03, Oneida County, New York",3115,2469,646,0.21,0.79
36065025100,"Census Tract 251, Oneida County, New York",1859,1629,230,0.12,0.88
36065025200,"Census Tract 252, Oneida County, New York",4486,4079,407,0.09,0.91
36065025300,"Census Tract 253, Oneida County, New York",7149,6200,949,0.13,0.87
36065025400,"Census Tract 254, Oneida County, New York",5938,5154,784,0.13,0.87
36065025500,"Census Tract 255, Oneida County, New York",4332,3991,341,0.08,0.92
36065025601,"Census Tract 256.01, Oneida County, New York",1966,1839,127,0.06,0.94
36065025602,"Census Tract 256.02, Oneida County, New York",2021,1903,118,0.06,0.94
36065025700,"Census Tract 257, Oneida County, New York",2327,2189,138,0.06,0.94
36065025800,"Census Tract 258, Oneida County, New York",1507,1290,217,0.14,0.86
36065025900,"Census Tract 259, Oneida County, New York",1338,484,854,0.64,0.36
36065026100,"Census Tract 261, Oneida County, New York",2542,2213,329,0.13,0.87
36065026200,"Census Tract 262, Oneida County, New York",6625,5895,730,0.11,0.89
36065026300,"Census Tract 263, Oneida County, New York",3692,2687,1005,0.27,0.73
36065026400,"Census Tract 264, Oneida County, New York",5573,1397,4176,0.75,0.25
36065026501,"Census Tract 265.01, Oneida County, New York",755,520,235,0.31,0.69
36065026502,"Census Tract 265.02, Oneida County, New York",265,218,47,0.18,0.82
36065026600,"Census Tract 266, Oneida County, New York",2152,741,1411,0.66,0.34
36065026700,"Census Tract 267, Oneida County, New York",5260,4974,286,0.05,0.95
36065980002,"Census Tract 9800.02, Oneida County, New York",12,5,7,0.58,0.42
36065980003,"Census Tract 9800.03, Oneida County, New York",6,0,6,1,0
36065980100,"Census Tract 9801, Oneida County, New York",23,11,12,0.52,0.48
36067000100,"Census Tract 1, Onondaga County, New York",1049,814,235,0.22,0.78
36067000200,"Census Tract 2, Onondaga County, New York",3642,1655,1987,0.55,0.45
36067000300,"Census Tract 3, Onondaga County, New York",1565,876,689,0.44,0.56
36067000400,"Census Tract 4, Onondaga County, New York",3720,2306,1414,0.38,0.62
36067000501,"Census Tract 5.01, Onondaga County, New York",2471,863,1608,0.65,0.35
36067000600,"Census Tract 6, Onondaga County, New York",3664,1154,2510,0.69,0.31
36067000700,"Census Tract 7, Onondaga County, New York",1892,561,1331,0.7,0.3
36067000800,"Census Tract 8, Onondaga County, New York",2913,1055,1858,0.64,0.36
36067000900,"Census Tract 9, Onondaga County, New York",3120,2212,908,0.29,0.71
36067001000,"Census Tract 10, Onondaga County, New York",4023,2088,1935,0.48,0.52
36067001400,"Census Tract 14, Onondaga County, New York",3225,708,2517,0.78,0.22
36067001500,"Census Tract 15, Onondaga County, New York",2781,836,1945,0.7,0.3
36067001600,"Census Tract 16, Onondaga County, New York",3270,1740,1530,0.47,0.53
36067001701,"Census Tract 17.01, Onondaga County, New York",2460,1184,1276,0.52,0.48
36067001702,"Census Tract 17.02, Onondaga County, New York",2572,1498,1074,0.42,0.58
36067001800,"Census Tract 18, Onondaga County, New York",2713,1804,909,0.34,0.66
36067001900,"Census Tract 19, Onondaga County, New York",3824,2691,1133,0.3,0.7
36067002000,"Census Tract 20, Onondaga County, New York",2171,1293,878,0.4,0.6
36067002101,"Census Tract 21.01, Onondaga County, New York",2789,1370,1419,0.51,0.49
36067002300,"Census Tract 23, Onondaga County, New York",1665,627,1038,0.62,0.38
36067002400,"Census Tract 24, Onondaga County, New York",1837,693,1144,0.62,0.38
36067002700,"Census Tract 27, Onondaga County, New York",1819,1276,543,0.3,0.7
36067002901,"Census Tract 29.01, Onondaga County, New York",2628,2070,558,0.21,0.79
36067003000,"Census Tract 30, Onondaga County, New York",2137,486,1651,0.77,0.23
36067003200,"Census Tract 32, Onondaga County, New York",3465,1747,1718,0.5,0.5
36067003400,"Census Tract 34, Onondaga County, New York",2673,1174,1499,0.56,0.44
36067003500,"Census Tract 35, Onondaga County, New York",2452,816,1636,0.67,0.33
36067003601,"Census Tract 36.01, Onondaga County, New York",2312,488,1824,0.79,0.21
36067003602,"Census Tract 36.02, Onondaga County, New York",2132,541,1591,0.75,0.25
36067003800,"Census Tract 38, Onondaga County, New York",2377,640,1737,0.73,0.27
36067003900,"Census Tract 39, Onondaga County, New York",3192,663,2529,0.79,0.21
36067004000,"Census Tract 40, Onondaga County, New York",1341,268,1073,0.8,0.2
36067004200,"Census Tract 42, Onondaga County, New York",2226,162,2064,0.93,0.07
36067004301,"Census Tract 43.01, Onondaga County, New York",1911,855,1056,0.55,0.45
36067004302,"Census Tract 43.02, Onondaga County, New York",7606,4945,2661,0.35,0.65
36067004401,"Census Tract 44.01, Onondaga County, New York",3508,2517,991,0.28,0.72
36067004500,"Census Tract 45, Onondaga County, New York",2795,1688,1107,0.4,0.6
36067004600,"Census Tract 46, Onondaga County, New York",5150,3590,1560,0.3,0.7
36067004800,"Census Tract 48, Onondaga County, New York",1351,1093,258,0.19,0.81
36067004900,"Census Tract 49, Onondaga County, New York",1554,785,769,0.49,0.51
36067005000,"Census Tract 50, Onondaga County, New York",2617,1608,1009,0.39,0.61
36067005100,"Census Tract 51, Onondaga County, New York",2287,421,1866,0.82,0.18
36067005200,"Census Tract 52, Onondaga County, New York",1930,142,1788,0.93,0.07
36067005300,"Census Tract 53, Onondaga County, New York",1866,295,1571,0.84,0.16
36067005400,"Census Tract 54, Onondaga County, New York",2403,219,2184,0.91,0.09
36067005500,"Census Tract 55, Onondaga County, New York",4754,1970,2784,0.59,0.41
36067005601,"Census Tract 56.01, Onondaga County, New York",1539,1091,448,0.29,0.71
36067005602,"Census Tract 56.02, Onondaga County, New York",2869,2000,869,0.3,0.7
36067005700,"Census Tract 57, Onondaga County, New York",1941,576,1365,0.7,0.3
36067005800,"Census Tract 58, Onondaga County, New York",2121,238,1883,0.89,0.11
36067005900,"Census Tract 59, Onondaga County, New York",1669,201,1468,0.88,0.12
36067006000,"Census Tract 60, Onondaga County, New York",3667,1426,2241,0.61,0.39
36067006101,"Census Tract 61.01, Onondaga County, New York",4451,1720,2731,0.61,0.39
36067006102,"Census Tract 61.02, Onondaga County, New York",1984,876,1108,0.56,0.44
36067006103,"Census Tract 61.03, Onondaga County, New York",2533,1594,939,0.37,0.63
36067010100,"Census Tract 101, Onondaga County, New York",2854,2612,242,0.08,0.92
36067010200,"Census Tract 102, Onondaga County, New York",6086,5392,694,0.11,0.89
36067010301,"Census Tract 103.01, Onondaga County, New York",5233,4598,635,0.12,0.88
36067010321,"Census Tract 103.21, Onondaga County, New York",2901,2543,358,0.12,0.88
36067010322,"Census Tract 103.22, Onondaga County, New York",3722,3260,462,0.12,0.88
36067010400,"Census Tract 104, Onondaga County, New York",4028,3595,433,0.11,0.89
36067010500,"Census Tract 105, Onondaga County, New York",2400,2135,265,0.11,0.89
36067010600,"Census Tract 106, Onondaga County, New York",2170,1869,301,0.14,0.86
36067010700,"Census Tract 107, Onondaga County, New York",2041,1710,331,0.16,0.84
36067010800,"Census Tract 108, Onondaga County, New York",4703,3978,725,0.15,0.85
36067010900,"Census Tract 109, Onondaga County, New York",2331,2097,234,0.1,0.9
36067011011,"Census Tract 110.11, Onondaga County, New York",3445,2893,552,0.16,0.84
36067011012,"Census Tract 110.12, Onondaga County, New York",4157,3086,1071,0.26,0.74
36067011021,"Census Tract 110.21, Onondaga County, New York",2821,2362,459,0.16,0.84
36067011022,"Census Tract 110.22, Onondaga County, New York",3081,2620,461,0.15,0.85
36067011101,"Census Tract 111.01, Onondaga County, New York",5914,4809,1105,0.19,0.81
36067011102,"Census Tract 111.02, Onondaga County, New York",3906,2522,1384,0.35,0.65
36067011201,"Census Tract 112.01, Onondaga County, New York",3775,3149,626,0.17,0.83
36067011202,"Census Tract 112.02, Onondaga County, New York",4670,3991,679,0.15,0.85
36067011231,"Census Tract 112.31, Onondaga County, New York",4650,3877,773,0.17,0.83
36067011232,"Census Tract 112.32, Onondaga County, New York",4322,3635,687,0.16,0.84
36067011241,"Census Tract 112.41, Onondaga County, New York",2586,2236,350,0.14,0.86
36067011242,"Census Tract 112.42, Onondaga County, New York",6014,4893,1121,0.19,0.81
36067011300,"Census Tract 113, Onondaga County, New York",4152,3577,575,0.14,0.86
36067011401,"Census Tract 114.01, Onondaga County, New York",7253,6508,745,0.1,0.9
36067011402,"Census Tract 114.02, Onondaga County, New York",4160,3832,328,0.08,0.92
36067011500,"Census Tract 115, Onondaga County, New York",6573,5828,745,0.11,0.89
36067011600,"Census Tract 116, Onondaga County, New York",5088,4581,507,0.1,0.9
36067011700,"Census Tract 117, Onondaga County, New York",4199,3735,464,0.11,0.89
36067011800,"Census Tract 118, Onondaga County, New York",6165,5407,758,0.12,0.88
36067011900,"Census Tract 119, Onondaga County, New York",4003,3618,385,0.1,0.9
36067012000,"Census Tract 120, Onondaga County, New York",5476,5009,467,0.09,0.91
36067012100,"Census Tract 121, Onondaga County, New York",5202,4791,411,0.08,0.92
36067012200,"Census Tract 122, Onondaga County, New York",1188,1041,147,0.12,0.88
36067012300,"Census Tract 123, Onondaga County, New York",3431,3111,320,0.09,0.91
36067012400,"Census Tract 124, Onondaga County, New York",4379,3828,551,0.13,0.87
36067012500,"Census Tract 125, Onondaga County, New York",3749,3049,700,0.19,0.81
36067012600,"Census Tract 126, Onondaga County, New York",5334,4753,581,0.11,0.89
36067012700,"Census Tract 127, Onondaga County, New York",2036,1796,240,0.12,0.88
36067012800,"Census Tract 128, Onondaga County, New York",2872,2623,249,0.09,0.91
36067012900,"Census Tract 129, Onondaga County, New York",2508,1854,654,0.26,0.74
36067013000,"Census Tract 130, Onondaga County, New York",4137,3430,707,0.17,0.83
36067013100,"Census Tract 131, Onondaga County, New York",4598,4163,435,0.09,0.91
36067013200,"Census Tract 132, Onondaga County, New York",3004,2699,305,0.1,0.9
36067013300,"Census Tract 133, Onondaga County, New York",2256,2014,242,0.11,0.89
36067013400,"Census Tract 134, Onondaga County, New York",5482,4699,783,0.14,0.86
36067013500,"Census Tract 135, Onondaga County, New York",4876,4060,816,0.17,0.83
36067013600,"Census Tract 136, Onondaga County, New York",3222,2458,764,0.24,0.76
36067013701,"Census Tract 137.01, Onondaga County, New York",4510,3481,1029,0.23,0.77
36067013800,"Census Tract 138, Onondaga County, New York",2169,1907,262,0.12,0.88
36067013900,"Census Tract 139, Onondaga County, New York",2741,2200,541,0.2,0.8
36067014000,"Census Tract 140, Onondaga County, New York",3642,2717,925,0.25,0.75
36067014200,"Census Tract 142, Onondaga County, New York",4315,3108,1207,0.28,0.72
36067014300,"Census Tract 143, Onondaga County, New York",3078,2373,705,0.23,0.77
36067014400,"Census Tract 144, Onondaga County, New York",2428,1933,495,0.2,0.8
36067014500,"Census Tract 145, Onondaga County, New York",3974,3270,704,0.18,0.82
36067014600,"Census Tract 146, Onondaga County, New York",5212,3516,1696,0.33,0.67
36067014700,"Census Tract 147, Onondaga County, New York",6123,4846,1277,0.21,0.79
36067014800,"Census Tract 148, Onondaga County, New York",3282,2763,519,0.16,0.84
36067014900,"Census Tract 149, Onondaga County, New York",1977,1541,436,0.22,0.78
36067015000,"Census Tract 150, Onondaga County, New York",4604,4002,602,0.13,0.87
36067015100,"Census Tract 151, Onondaga County, New York",5913,5097,816,0.14,0.86
36067015201,"Census Tract 152.01, Onondaga County, New York",3339,2727,612,0.18,0.82
36067015202,"Census Tract 152.02, Onondaga County, New York",4724,3716,1008,0.21,0.79
36067015203,"Census Tract 152.03, Onondaga County, New York",2763,2261,502,0.18,0.82
36067015400,"Census Tract 154, Onondaga County, New York",5952,5317,635,0.11,0.89
36067015500,"Census Tract 155, Onondaga County, New York",2780,2550,230,0.08,0.92
36067015601,"Census Tract 156.01, Onondaga County, New York",2074,1902,172,0.08,0.92
36067015602,"Census Tract 156.02, Onondaga County, New York",1563,1326,237,0.15,0.85
36067015701,"Census Tract 157.01, Onondaga County, New York",2345,2147,198,0.08,0.92
36067015702,"Census Tract 157.02, Onondaga County, New York",4735,3990,745,0.16,0.84
36067015800,"Census Tract 158, Onondaga County, New York",4910,4441,469,0.1,0.9
36067016001,"Census Tract 160.01, Onondaga County, New York",3373,3057,316,0.09,0.91
36067016002,"Census Tract 160.02, Onondaga County, New York",2820,2618,202,0.07,0.93
36067016100,"Census Tract 161, Onondaga County, New York",2478,1733,745,0.3,0.7
36067016200,"Census Tract 162, Onondaga County, New York",2132,1470,662,0.31,0.69
36067016300,"Census Tract 163, Onondaga County, New York",8108,6653,1455,0.18,0.82
36067016400,"Census Tract 164, Onondaga County, New York",4026,3346,680,0.17,0.83
36067016501,"Census Tract 165.01, Onondaga County, New York",1782,1667,115,0.06,0.94
36067016502,"Census Tract 165.02, Onondaga County, New York",4284,4013,271,0.06,0.94
36067016600,"Census Tract 166, Onondaga County, New York",4656,4334,322,0.07,0.93
36067016700,"Census Tract 167, Onondaga County, New York",2456,2281,175,0.07,0.93
36067016801,"Census Tract 168.01, Onondaga County, New York",1588,1506,82,0.05,0.95
36067016802,"Census Tract 168.02, Onondaga County, New York",2368,2177,191,0.08,0.92
36067016901,"Census Tract 169.01, Onondaga County, New York",2676,2473,203,0.08,0.92
36067016902,"Census Tract 169.02, Onondaga County, New York",2006,1846,160,0.08,0.92
36067940000,"Census Tract 9400, Onondaga County, New York",831,450,381,0.46,0.54
36069050101,"Census Tract 501.01, Ontario County, New York",3298,2936,362,0.11,0.89
36069050103,"Census Tract 501.03, Ontario County, New York",3289,2896,393,0.12,0.88
36069050104,"Census Tract 501.04, Ontario County, New York",4206,3741,465,0.11,0.89
36069050105,"Census Tract 501.05, Ontario County, New York",3426,3100,326,0.1,0.9
36069050106,"Census Tract 501.06, Ontario County, New York",1641,1507,134,0.08,0.92
36069050203,"Census Tract 502.03, Ontario County, New York",4357,3315,1042,0.24,0.76
36069050204,"Census Tract 502.04, Ontario County, New York",3168,2934,234,0.07,0.93
36069050205,"Census Tract 502.05, Ontario County, New York",4886,4128,758,0.16,0.84
36069050206,"Census Tract 502.06, Ontario County, New York",1759,1479,280,0.16,0.84
36069050302,"Census Tract 503.02, Ontario County, New York",4045,3696,349,0.09,0.91
36069050303,"Census Tract 503.03, Ontario County, New York",2839,2454,385,0.14,0.86
36069050304,"Census Tract 503.04, Ontario County, New York",2520,2249,271,0.11,0.89
36069050401,"Census Tract 504.01, Ontario County, New York",3294,3003,291,0.09,0.91
36069050402,"Census Tract 504.02, Ontario County, New York",3343,3062,281,0.08,0.92
36069050501,"Census Tract 505.01, Ontario County, New York",3640,3327,313,0.09,0.91
36069050502,"Census Tract 505.02, Ontario County, New York",2740,2515,225,0.08,0.92
36069050601,"Census Tract 506.01, Ontario County, New York",5774,5387,387,0.07,0.93
36069050603,"Census Tract 506.03, Ontario County, New York",2790,2457,333,0.12,0.88
36069050604,"Census Tract 506.04, Ontario County, New York",2545,2238,307,0.12,0.88
36069050800,"Census Tract 508, Ontario County, New York",3074,2726,348,0.11,0.89
36069050900,"Census Tract 509, Ontario County, New York",2362,2092,270,0.11,0.89
36069051001,"Census Tract 510.01, Ontario County, New York",1844,1628,216,0.12,0.88
36069051101,"Census Tract 511.01, Ontario County, New York",1793,1493,300,0.17,0.83
36069051102,"Census Tract 511.02, Ontario County, New York",1503,1347,156,0.1,0.9
36069051200,"Census Tract 512, Ontario County, New York",3931,3465,466,0.12,0.88
36069051301,"Census Tract 513.01, Ontario County, New York",1584,1476,108,0.07,0.93
36069051302,"Census Tract 513.02, Ontario County, New York",2522,2346,176,0.07,0.93
36069051400,"Census Tract 514, Ontario County, New York",2644,2439,205,0.08,0.92
36069051501,"Census Tract 515.01, Ontario County, New York",1968,1739,229,0.12,0.88
36069051502,"Census Tract 515.02, Ontario County, New York",1496,1008,488,0.33,0.67
36069051600,"Census Tract 516, Ontario County, New York",1670,1401,269,0.16,0.84
36069051700,"Census Tract 517, Ontario County, New York",2556,1318,1238,0.48,0.52
36069051801,"Census Tract 518.01, Ontario County, New York",5407,3449,1958,0.36,0.64
36069051900,"Census Tract 519, Ontario County, New York",3188,2482,706,0.22,0.78
36069052001,"Census Tract 520.01, Ontario County, New York",1668,1546,122,0.07,0.93
36069052002,"Census Tract 520.02, Ontario County, New York",1691,1577,114,0.07,0.93
36069052003,"Census Tract 520.03, Ontario County, New York",1669,1570,99,0.06,0.94
36069052101,"Census Tract 521.01, Ontario County, New York",1641,1546,95,0.06,0.94
36069052102,"Census Tract 521.02, Ontario County, New York",2284,2103,181,0.08,0.92
36069052200,"Census Tract 522, Ontario County, New York",2403,2222,181,0.08,0.92
36071000100,"Census Tract 1, Orange County, New York",3137,1143,1994,0.64,0.36
36071000200,"Census Tract 2, Orange County, New York",2638,712,1926,0.73,0.27
36071000301,"Census Tract 3.01, Orange County, New York",2136,125,2011,0.94,0.06
36071000302,"Census Tract 3.02, Orange County, New York",4327,685,3642,0.84,0.16
36071000400,"Census Tract 4, Orange County, New York",5086,769,4317,0.85,0.15
36071000501,"Census Tract 5.01, Orange County, New York",3310,359,2951,0.89,0.11
36071000502,"Census Tract 5.02, Orange County, New York",4208,401,3807,0.9,0.1
36071000600,"Census Tract 6, Orange County, New York",4014,639,3375,0.84,0.16
36071001100,"Census Tract 11, Orange County, New York",4775,1101,3674,0.77,0.23
36071001200,"Census Tract 12, Orange County, New York",2564,406,2158,0.84,0.16
36071001300,"Census Tract 13, Orange County, New York",3377,1320,2057,0.61,0.39
36071001500,"Census Tract 15, Orange County, New York",5514,1462,4052,0.73,0.27
36071001601,"Census Tract 16.01, Orange County, New York",5294,1423,3871,0.73,0.27
36071001602,"Census Tract 16.02, Orange County, New York",2762,1033,1729,0.63,0.37
36071002100,"Census Tract 21, Orange County, New York",3255,2283,972,0.3,0.7
36071002200,"Census Tract 22, Orange County, New York",3401,2127,1274,0.37,0.63
36071002300,"Census Tract 23, Orange County, New York",2119,1433,686,0.32,0.68
36071010101,"Census Tract 101.01, Orange County, New York",4880,3204,1676,0.34,0.66
36071010102,"Census Tract 101.02, Orange County, New York",5690,3340,2350,0.41,0.59
36071010200,"Census Tract 102, Orange County, New York",5042,3100,1942,0.39,0.61
36071010300,"Census Tract 103, Orange County, New York",3554,1986,1568,0.44,0.56
36071010400,"Census Tract 104, Orange County, New York",4208,2345,1863,0.44,0.56
36071010501,"Census Tract 105.01, Orange County, New York",3520,2023,1497,0.43,0.57
36071010502,"Census Tract 105.02, Orange County, New York",5091,2412,2679,0.53,0.47
36071010601,"Census Tract 106.01, Orange County, New York",3500,2763,737,0.21,0.79
36071010602,"Census Tract 106.02, Orange County, New York",3772,2768,1004,0.27,0.73
36071010701,"Census Tract 107.01, Orange County, New York",2570,1441,1129,0.44,0.56
36071010702,"Census Tract 107.02, Orange County, New York",4248,2668,1580,0.37,0.63
36071010801,"Census Tract 108.01, Orange County, New York",3979,2281,1698,0.43,0.57
36071010802,"Census Tract 108.02, Orange County, New York",5297,3897,1400,0.26,0.74
36071010901,"Census Tract 109.01, Orange County, New York",3458,2642,816,0.24,0.76
36071010902,"Census Tract 109.02, Orange County, New York",5672,4205,1467,0.26,0.74
36071011000,"Census Tract 110, Orange County, New York",5114,3351,1763,0.34,0.66
36071011101,"Census Tract 111.01, Orange County, New York",3094,1130,1964,0.63,0.37
36071011102,"Census Tract 111.02, Orange County, New York",4659,1854,2805,0.6,0.4
36071011200,"Census Tract 112, Orange County, New York",5236,1727,3509,0.67,0.33
36071011301,"Census Tract 113.01, Orange County, New York",4695,1652,3043,0.65,0.35
36071011302,"Census Tract 113.02, Orange County, New York",3452,1107,2345,0.68,0.32
36071011400,"Census Tract 114, Orange County, New York",4170,2631,1539,0.37,0.63
36071011500,"Census Tract 115, Orange County, New York",6537,4079,2458,0.38,0.62
36071011601,"Census Tract 116.01, Orange County, New York",3927,3025,902,0.23,0.77
36071011602,"Census Tract 116.02, Orange County, New York",3582,2826,756,0.21,0.79
36071011701,"Census Tract 117.01, Orange County, New York",4689,3652,1037,0.22,0.78
36071011702,"Census Tract 117.02, Orange County, New York",4621,3657,964,0.21,0.79
36071011801,"Census Tract 118.01, Orange County, New York",4802,3186,1616,0.34,0.66
36071011802,"Census Tract 118.02, Orange County, New York",2732,2086,646,0.24,0.76
36071011900,"Census Tract 119, Orange County, New York",6581,4263,2318,0.35,0.65
36071012100,"Census Tract 121, Orange County, New York",3844,2318,1526,0.4,0.6
36071012200,"Census Tract 122, Orange County, New York",4146,3023,1123,0.27,0.73
36071012300,"Census Tract 123, Orange County, New York",5415,4040,1375,0.25,0.75
36071012601,"Census Tract 126.01, Orange County, New York",4184,1983,2201,0.53,0.47
36071012602,"Census Tract 126.02, Orange County, New York",3368,1259,2109,0.63,0.37
36071012700,"Census Tract 127, Orange County, New York",4012,1986,2026,0.5,0.5
36071012800,"Census Tract 128, Orange County, New York",4975,2820,2155,0.43,0.57
36071012900,"Census Tract 129, Orange County, New York",3190,2561,629,0.2,0.8
36071013000,"Census Tract 130, Orange County, New York",4578,3236,1342,0.29,0.71
36071013100,"Census Tract 131, Orange County, New York",5116,3964,1152,0.23,0.77
36071013201,"Census Tract 132.01, Orange County, New York",4975,3009,1966,0.4,0.6
36071013202,"Census Tract 132.02, Orange County, New York",2354,1367,987,0.42,0.58
36071013301,"Census Tract 133.01, Orange County, New York",4609,2922,1687,0.37,0.63
36071013302,"Census Tract 133.02, Orange County, New York",2827,1923,904,0.32,0.68
36071013400,"Census Tract 134, Orange County, New York",4046,2760,1286,0.32,0.68
36071013500,"Census Tract 135, Orange County, New York",6337,3651,2686,0.42,0.58
36071013600,"Census Tract 136, Orange County, New York",7306,5005,2301,0.31,0.69
36071013700,"Census Tract 137, Orange County, New York",2640,1155,1485,0.56,0.44
36071013800,"Census Tract 138, Orange County, New York",2993,2075,918,0.31,0.69
36071013900,"Census Tract 139, Orange County, New York",5189,3164,2025,0.39,0.61
36071014101,"Census Tract 141.01, Orange County, New York",4849,2361,2488,0.51,0.49
36071014102,"Census Tract 141.02, Orange County, New York",5819,2685,3134,0.54,0.46
36071014201,"Census Tract 142.01, Orange County, New York",4059,2601,1458,0.36,0.64
36071014202,"Census Tract 142.02, Orange County, New York",6801,4493,2308,0.34,0.66
36071014301,"Census Tract 143.01, Orange County, New York",5229,2958,2271,0.43,0.57
36071014302,"Census Tract 143.02, Orange County, New York",7417,5107,2310,0.31,0.69
36071014400,"Census Tract 144, Orange County, New York",4703,3389,1314,0.28,0.72
36071014501,"Census Tract 145.01, Orange County, New York",4349,3406,943,0.22,0.78
36071014502,"Census Tract 145.02, Orange County, New York",5624,4572,1052,0.19,0.81
36071014601,"Census Tract 146.01, Orange County, New York",3694,3099,595,0.16,0.84
36071014602,"Census Tract 146.02, Orange County, New York",3066,2345,721,0.24,0.76
36071014700,"Census Tract 147, Orange County, New York",3711,2440,1271,0.34,0.66
36071014801,"Census Tract 148.01, Orange County, New York",3842,2902,940,0.24,0.76
36071014802,"Census Tract 148.02, Orange County, New York",3038,2260,778,0.26,0.74
36071014900,"Census Tract 149, Orange County, New York",3811,2831,980,0.26,0.74
36071015003,"Census Tract 150.03, Orange County, New York",8363,5875,2488,0.3,0.7
36071015005,"Census Tract 150.05, Orange County, New York",7452,5020,2432,0.33,0.67
36071015007,"Census Tract 150.07, Orange County, New York",5319,3751,1568,0.29,0.71
36071015008,"Census Tract 150.08, Orange County, New York",4517,3322,1195,0.26,0.74
36071015009,"Census Tract 150.09, Orange County, New York",2722,2034,688,0.25,0.75
36071015010,"Census Tract 150.10, Orange County, New York",5111,3506,1605,0.31,0.69
36071015100,"Census Tract 151, Orange County, New York",6125,1503,4622,0.75,0.25
36071015201,"Census Tract 152.01, Orange County, New York",4549,3124,1425,0.31,0.69
36071015202,"Census Tract 152.02, Orange County, New York",4981,2399,2582,0.52,0.48
36071015203,"Census Tract 152.03, Orange County, New York",1766,922,844,0.48,0.52
36073040200,"Census Tract 402, Orleans County, New York",3107,2868,239,0.08,0.92
36073040300,"Census Tract 403, Orleans County, New York",2297,2064,233,0.1,0.9
36073040400,"Census Tract 404, Orleans County, New York",3491,2836,655,0.19,0.81
36073040500,"Census Tract 405, Orleans County, New York",2610,2084,526,0.2,0.8
36073040601,"Census Tract 406.01, Orleans County, New York",1764,1602,162,0.09,0.91
36073040602,"Census Tract 406.02, Orleans County, New York",1472,612,860,0.58,0.42
36073040603,"Census Tract 406.03, Orleans County, New York",3616,3166,450,0.12,0.88
36073040701,"Census Tract 407.01, Orleans County, New York",2664,1949,715,0.27,0.73
36073040702,"Census Tract 407.02, Orleans County, New York",3192,2486,706,0.22,0.78
36073040801,"Census Tract 408.01, Orleans County, New York",3315,3029,286,0.09,0.91
36073040802,"Census Tract 408.02, Orleans County, New York",4796,4156,640,0.13,0.87
36073401200,"Census Tract 4012, Orleans County, New York",3455,3151,304,0.09,0.91
36073401300,"Census Tract 4013, Orleans County, New York",4564,4034,530,0.12,0.88
36073990000,"Census Tract 9900, Orleans County, New York",0,0,0,0,0
36075020101,"Census Tract 201.01, Oswego County, New York",2165,2036,129,0.06,0.94
36075020102,"Census Tract 201.02, Oswego County, New York",1221,1121,100,0.08,0.92
36075020201,"Census Tract 202.01, Oswego County, New York",2510,2355,155,0.06,0.94
36075020202,"Census Tract 202.02, Oswego County, New York",1303,1205,98,0.08,0.92
36075020301,"Census Tract 203.01, Oswego County, New York",2186,2016,170,0.08,0.92
36075020303,"Census Tract 203.03, Oswego County, New York",1779,1689,90,0.05,0.95
36075020304,"Census Tract 203.04, Oswego County, New York",1672,1569,103,0.06,0.94
36075020400,"Census Tract 204, Oswego County, New York",5259,4875,384,0.07,0.93
36075020501,"Census Tract 205.01, Oswego County, New York",1930,1776,154,0.08,0.92
36075020502,"Census Tract 205.02, Oswego County, New York",2581,2416,165,0.06,0.94
36075020503,"Census Tract 205.03, Oswego County, New York",1141,1059,82,0.07,0.93
36075020600,"Census Tract 206, Oswego County, New York",4778,4408,370,0.08,0.92
36075020703,"Census Tract 207.03, Oswego County, New York",5013,4682,331,0.07,0.93
36075020704,"Census Tract 207.04, Oswego County, New York",1874,1771,103,0.05,0.95
36075020705,"Census Tract 207.05, Oswego County, New York",2214,2074,140,0.06,0.94
36075020706,"Census Tract 207.06, Oswego County, New York",2434,2248,186,0.08,0.92
36075020707,"Census Tract 207.07, Oswego County, New York",1895,1752,143,0.08,0.92
36075020800,"Census Tract 208, Oswego County, New York",3470,3181,289,0.08,0.92
36075020901,"Census Tract 209.01, Oswego County, New York",2226,1985,241,0.11,0.89
36075020903,"Census Tract 209.03, Oswego County, New York",2465,2290,175,0.07,0.93
36075020904,"Census Tract 209.04, Oswego County, New York",2174,2004,170,0.08,0.92
36075020905,"Census Tract 209.05, Oswego County, New York",1104,988,116,0.11,0.89
36075021001,"Census Tract 210.01, Oswego County, New York",2544,2348,196,0.08,0.92
36075021002,"Census Tract 210.02, Oswego County, New York",2028,1859,169,0.08,0.92
36075021003,"Census Tract 210.03, Oswego County, New York",1099,1043,56,0.05,0.95
36075021101,"Census Tract 211.01, Oswego County, New York",3652,3148,504,0.14,0.86
36075021102,"Census Tract 211.02, Oswego County, New York",2135,1787,348,0.16,0.84
36075021103,"Census Tract 211.03, Oswego County, New York",2941,2654,287,0.1,0.9
36075021104,"Census Tract 211.04, Oswego County, New York",2661,2382,279,0.1,0.9
36075021201,"Census Tract 212.01, Oswego County, New York",1257,1119,138,0.11,0.89
36075021202,"Census Tract 212.02, Oswego County, New York",2469,2223,246,0.1,0.9
36075021203,"Census Tract 212.03, Oswego County, New York",2794,2550,244,0.09,0.91
36075021300,"Census Tract 213, Oswego County, New York",4525,4159,366,0.08,0.92
36075021401,"Census Tract 214.01, Oswego County, New York",7914,6261,1653,0.21,0.79
36075021402,"Census Tract 214.02, Oswego County, New York",1643,1497,146,0.09,0.91
36075021501,"Census Tract 215.01, Oswego County, New York",2931,2699,232,0.08,0.92
36075021503,"Census Tract 215.03, Oswego County, New York",2398,2225,173,0.07,0.93
36075021504,"Census Tract 215.04, Oswego County, New York",2635,2417,218,0.08,0.92
36075021505,"Census Tract 215.05, Oswego County, New York",1584,1364,220,0.14,0.86
36075021601,"Census Tract 216.01, Oswego County, New York",2441,2059,382,0.16,0.84
36075021602,"Census Tract 216.02, Oswego County, New York",2821,2396,425,0.15,0.85
36075021603,"Census Tract 216.03, Oswego County, New York",3803,3362,441,0.12,0.88
36075021604,"Census Tract 216.04, Oswego County, New York",4375,3693,682,0.16,0.84
36075021605,"Census Tract 216.05, Oswego County, New York",3481,2965,516,0.15,0.85
36075990000,"Census Tract 9900, Oswego County, New York",0,0,0,0,0
36077590101,"Census Tract 5901.01, Otsego County, New York",2575,2400,175,0.07,0.93
36077590102,"Census Tract 5901.02, Otsego County, New York",1882,1699,183,0.1,0.9
36077590201,"Census Tract 5902.01, Otsego County, New York",1952,1748,204,0.1,0.9
36077590202,"Census Tract 5902.02, Otsego County, New York",3641,3214,427,0.12,0.88
36077590301,"Census Tract 5903.01, Otsego County, New York",2065,1910,155,0.08,0.92
36077590302,"Census Tract 5903.02, Otsego County, New York",1767,1665,102,0.06,0.94
36077590401,"Census Tract 5904.01, Otsego County, New York",1907,1795,112,0.06,0.94
36077590402,"Census Tract 5904.02, Otsego County, New York",3441,3220,221,0.06,0.94
36077590500,"Census Tract 5905, Otsego County, New York",2827,2554,273,0.1,0.9
36077590600,"Census Tract 5906, Otsego County, New York",1868,1740,128,0.07,0.93
36077590701,"Census Tract 5907.01, Otsego County, New York",1760,1629,131,0.07,0.93
36077590702,"Census Tract 5907.02, Otsego County, New York",2112,1894,218,0.1,0.9
36077590800,"Census Tract 5908, Otsego County, New York",5065,4260,805,0.16,0.84
36077590900,"Census Tract 5909, Otsego County, New York",2266,1773,493,0.22,0.78
36077591000,"Census Tract 5910, Otsego County, New York",3584,2882,702,0.2,0.8
36077591100,"Census Tract 5911, Otsego County, New York",2514,2001,513,0.2,0.8
36077591401,"Census Tract 5914.01, Otsego County, New York",2756,2448,308,0.11,0.89
36077591402,"Census Tract 5914.02, Otsego County, New York",2311,2046,265,0.11,0.89
36077591500,"Census Tract 5915, Otsego County, New York",3400,3122,278,0.08,0.92
36077591601,"Census Tract 5916.01, Otsego County, New York",1811,1657,154,0.09,0.91
36077591602,"Census Tract 5916.02, Otsego County, New York",2305,2152,153,0.07,0.93
36077591700,"Census Tract 5917, Otsego County, New York",4715,3681,1034,0.22,0.78
36079010100,"Census Tract 101, Putnam County, New York",3602,2349,1253,0.35,0.65
36079010201,"Census Tract 102.01, Putnam County, New York",4312,3237,1075,0.25,0.75
36079010202,"Census Tract 102.02, Putnam County, New York",3627,2286,1341,0.37,0.63
36079010300,"Census Tract 103, Putnam County, New York",4716,3095,1621,0.34,0.66
36079010400,"Census Tract 104, Putnam County, New York",3277,2174,1103,0.34,0.66
36079010500,"Census Tract 105, Putnam County, New York",4907,3694,1213,0.25,0.75
36079010600,"Census Tract 106, Putnam County, New York",3738,3168,570,0.15,0.85
36079010700,"Census Tract 107, Putnam County, New York",2610,2223,387,0.15,0.85
36079010800,"Census Tract 108, Putnam County, New York",3483,2696,787,0.23,0.77
36079010901,"Census Tract 109.01, Putnam County, New York",3591,2467,1124,0.31,0.69
36079010902,"Census Tract 109.02, Putnam County, New York",4175,3180,995,0.24,0.76
36079011000,"Census Tract 110, Putnam County, New York",3996,3212,784,0.2,0.8
36079011100,"Census Tract 111, Putnam County, New York",5113,3853,1260,0.25,0.75
36079011201,"Census Tract 112.01, Putnam County, New York",2549,2023,526,0.21,0.79
36079011202,"Census Tract 112.02, Putnam County, New York",4056,3077,979,0.24,0.76
36079011300,"Census Tract 113, Putnam County, New York",4121,3193,928,0.23,0.77
36079011400,"Census Tract 114, Putnam County, New York",5157,4097,1060,0.21,0.79
36079011501,"Census Tract 115.01, Putnam County, New York",3978,2815,1163,0.29,0.71
36079011502,"Census Tract 115.02, Putnam County, New York",2960,2197,763,0.26,0.74
36079011600,"Census Tract 116, Putnam County, New York",5642,4576,1066,0.19,0.81
36079011700,"Census Tract 117, Putnam County, New York",4834,3852,982,0.2,0.8
36079011801,"Census Tract 118.01, Putnam County, New York",3742,1488,2254,0.6,0.4
36079011802,"Census Tract 118.02, Putnam County, New York",4259,3075,1184,0.28,0.72
36079011900,"Census Tract 119, Putnam County, New York",5223,3915,1308,0.25,0.75
36081000101,"Census Tract 1.01, Queens County, New York",4659,2292,2367,0.51,0.49
36081000102,"Census Tract 1.02, Queens County, New York",7484,4156,3328,0.44,0.56
36081000103,"Census Tract 1.03, Queens County, New York",33,9,24,0.73,0.27
36081000104,"Census Tract 1.04, Queens County, New York",27,1,26,0.96,0.04
36081000200,"Census Tract 2, Queens County, New York",3084,367,2717,0.88,0.12
36081000400,"Census Tract 4, Queens County, New York",4918,225,4693,0.95,0.05
36081000600,"Census Tract 6, Queens County, New York",4177,302,3875,0.93,0.07
36081000701,"Census Tract 7.01, Queens County, New York",3460,1739,1721,0.5,0.5
36081000702,"Census Tract 7.02, Queens County, New York",4260,1963,2297,0.54,0.46
36081000800,"Census Tract 8, Queens County, New York",3580,336,3244,0.91,0.09
36081001000,"Census Tract 10, Queens County, New York",3789,320,3469,0.92,0.08
36081001200,"Census Tract 12, Queens County, New York",4183,674,3509,0.84,0.16
36081001400,"Census Tract 14, Queens County, New York",4114,611,3503,0.85,0.15
36081001600,"Census Tract 16, Queens County, New York",3041,316,2725,0.9,0.1
36081001800,"Census Tract 18, Queens County, New York",3044,310,2734,0.9,0.1
36081001901,"Census Tract 19.01, Queens County, New York",1434,649,785,0.55,0.45
36081001902,"Census Tract 19.02, Queens County, New York",8645,2716,5929,0.69,0.31
36081001903,"Census Tract 19.03, Queens County, New York",2214,821,1393,0.63,0.37
36081002000,"Census Tract 20, Queens County, New York",1871,196,1675,0.9,0.1
36081002200,"Census Tract 22, Queens County, New York",2290,322,1968,0.86,0.14
36081002400,"Census Tract 24, Queens County, New York",2195,240,1955,0.89,0.11
36081002500,"Census Tract 25, Queens County, New York",7242,178,7064,0.98,0.02
36081002600,"Census Tract 26, Queens County, New York",2150,363,1787,0.83,0.17
36081002800,"Census Tract 28, Queens County, New York",3304,304,3000,0.91,0.09
36081003000,"Census Tract 30, Queens County, New York",1479,200,1279,0.86,0.14
36081003100,"Census Tract 31, Queens County, New York",2157,741,1416,0.66,0.34
36081003200,"Census Tract 32, Queens County, New York",1791,171,1620,0.9,0.1
36081003301,"Census Tract 33.01, Queens County, New York",4399,1650,2749,0.62,0.38
36081003302,"Census Tract 33.02, Queens County, New York",2166,414,1752,0.81,0.19
36081003400,"Census Tract 34, Queens County, New York",2442,196,2246,0.92,0.08
36081003600,"Census Tract 36, Queens County, New York",4195,277,3918,0.93,0.07
36081003700,"Census Tract 37, Queens County, New York",2,1,1,0.5,0.5
36081003800,"Census Tract 38, Queens County, New York",2490,265,2225,0.89,0.11
36081003900,"Census Tract 39, Queens County, New York",1462,376,1086,0.74,0.26
36081004001,"Census Tract 40.01, Queens County, New York",2403,475,1928,0.8,0.2
36081004002,"Census Tract 40.02, Queens County, New York",1361,118,1243,0.91,0.09
36081004200,"Census Tract 42, Queens County, New York",4505,277,4228,0.94,0.06
36081004300,"Census Tract 43, Queens County, New York",2326,107,2219,0.95,0.05
36081004401,"Census Tract 44.01, Queens County, New York",3916,270,3646,0.93,0.07
36081004500,"Census Tract 45, Queens County, New York",3252,1681,1571,0.48,0.52
36081004700,"Census Tract 47, Queens County, New York",4090,899,3191,0.78,0.22
36081005000,"Census Tract 50, Queens County, New York",0,0,0,0,0
36081005100,"Census Tract 51, Queens County, New York",2512,750,1762,0.7,0.3
36081005200,"Census Tract 52, Queens County, New York",3080,223,2857,0.93,0.07
36081005300,"Census Tract 53, Queens County, New York",5397,2689,2708,0.5,0.5
36081005400,"Census Tract 54, Queens County, New York",5609,887,4722,0.84,0.16
36081005500,"Census Tract 55, Queens County, New York",1367,380,987,0.72,0.28
36081005700,"Census Tract 57, Queens County, New York",4277,1790,2487,0.58,0.42
36081005800,"Census Tract 58, Queens County, New York",6194,1398,4796,0.77,0.23
36081005900,"Census Tract 59, Queens County, New York",4231,2334,1897,0.45,0.55
36081006100,"Census Tract 61, Queens County, New York",6291,3446,2845,0.45,0.55
36081006201,"Census Tract 62.01, Queens County, New York",5389,3011,2378,0.44,0.56
36081006202,"Census Tract 62.02, Queens County, New York",6949,2777,4172,0.6,0.4
36081006300,"Census Tract 63, Queens County, New York",5877,3405,2472,0.42,0.58
36081006501,"Census Tract 65.01, Queens County, New York",3645,1983,1662,0.46,0.54
36081006502,"Census Tract 65.02, Queens County, New York",4004,2295,1709,0.43,0.57
36081006900,"Census Tract 69, Queens County, New York",5196,2357,2839,0.55,0.45
36081007100,"Census Tract 71, Queens County, New York",4355,2276,2079,0.48,0.52
36081007300,"Census Tract 73, Queens County, New York",4470,2535,1935,0.43,0.57
36081007500,"Census Tract 75, Queens County, New York",4477,2196,2281,0.51,0.49
36081007700,"Census Tract 77, Queens County, New York",2114,917,1197,0.57,0.43
36081007900,"Census Tract 79, Queens County, New York",3628,1403,2225,0.61,0.39
36081008100,"Census Tract 81, Queens County, New York",1761,810,951,0.54,0.46
36081008300,"Census Tract 83, Queens County, New York",3515,1191,2324,0.66,0.34
36081008500,"Census Tract 85, Queens County, New York",1979,456,1523,0.77,0.23
36081008600,"Census Tract 86, Queens County, New York",2989,766,2223,0.74,0.26
36081008700,"Census Tract 87, Queens County, New York",5176,580,4596,0.89,0.11
36081008800,"Census Tract 88, Queens County, New York",3449,1114,2335,0.68,0.32
36081009100,"Census Tract 91, Queens County, New York",2733,1385,1348,0.49,0.51
36081009400,"Census Tract 94, Queens County, New York",2919,160,2759,0.95,0.05
36081009500,"Census Tract 95, Queens County, New York",2510,1623,887,0.35,0.65
36081009600,"Census Tract 96, Queens County, New York",3127,191,2936,0.94,0.06
36081009700,"Census Tract 97, Queens County, New York",3860,2704,1156,0.3,0.7
36081009800,"Census Tract 98, Queens County, New York",2631,172,2459,0.93,0.07
36081009900,"Census Tract 99, Queens County, New York",0,0,0,0,0
36081010000,"Census Tract 100, Queens County, New York",3383,262,3121,0.92,0.08
36081010100,"Census Tract 101, Queens County, New York",2654,1870,784,0.3,0.7
36081010200,"Census Tract 102, Queens County, New York",2866,238,2628,0.92,0.08
36081010300,"Census Tract 103, Queens County, New York",4150,2521,1629,0.39,0.61
36081010400,"Census Tract 104, Queens County, New York",3315,234,3081,0.93,0.07
36081010500,"Census Tract 105, Queens County, New York",4641,2212,2429,0.52,0.48
36081010600,"Census Tract 106, Queens County, New York",3417,174,3243,0.95,0.05
36081010701,"Census Tract 107.01, Queens County, New York",7,1,6,0.86,0.14
36081010800,"Census Tract 108, Queens County, New York",3034,113,2921,0.96,0.04
36081011000,"Census Tract 110, Queens County, New York",3190,145,3045,0.95,0.05
36081011100,"Census Tract 111, Queens County, New York",2902,1797,1105,0.38,0.62
36081011200,"Census Tract 112, Queens County, New York",2497,290,2207,0.88,0.12
36081011300,"Census Tract 113, Queens County, New York",4280,2438,1842,0.43,0.57
36081011400,"Census Tract 114, Queens County, New York",1539,194,1345,0.87,0.13
36081011500,"Census Tract 115, Queens County, New York",2414,1442,972,0.4,0.6
36081011600,"Census Tract 116, Queens County, New York",2370,216,2154,0.91,0.09
36081011700,"Census Tract 117, Queens County, New York",3840,2574,1266,0.33,0.67
36081011800,"Census Tract 118, Queens County, New York",2690,174,2516,0.94,0.06
36081011900,"Census Tract 119, Queens County, New York",1729,1102,627,0.36,0.64
36081012000,"Census Tract 120, Queens County, New York",2385,115,2270,0.95,0.05
36081012100,"Census Tract 121, Queens County, New York",2177,1476,701,0.32,0.68
36081012200,"Census Tract 122, Queens County, New York",2802,185,2617,0.93,0.07
36081012301,"Census Tract 123.01, Queens County, New York",3272,2220,1052,0.32,0.68
36081012400,"Census Tract 124, Queens County, New York",2873,202,2671,0.93,0.07
36081012500,"Census Tract 125, Queens County, New York",1735,934,801,0.46,0.54
36081012601,"Census Tract 126.01, Queens County, New York",2596,216,2380,0.92,0.08
36081012602,"Census Tract 126.02, Queens County, New York",2715,219,2496,0.92,0.08
36081012800,"Census Tract 128, Queens County, New York",2212,610,1602,0.72,0.28
36081013000,"Census Tract 130, Queens County, New York",1757,571,1186,0.68,0.32
36081013200,"Census Tract 132, Queens County, New York",1919,643,1276,0.66,0.34
36081013400,"Census Tract 134, Queens County, New York",5904,2711,3193,0.54,0.46
36081013500,"Census Tract 135, Queens County, New York",1526,1206,320,0.21,0.79
36081013600,"Census Tract 136, Queens County, New York",1994,896,1098,0.55,0.45
36081013700,"Census Tract 137, Queens County, New York",1747,1160,587,0.34,0.66
36081013800,"Census Tract 138, Queens County, New York",3785,1154,2631,0.7,0.3
36081014000,"Census Tract 140, Queens County, New York",3952,1558,2394,0.61,0.39
36081014100,"Census Tract 141, Queens County, New York",1645,938,707,0.43,0.57
36081014201,"Census Tract 142.01, Queens County, New York",4702,187,4515,0.96,0.04
36081014202,"Census Tract 142.02, Queens County, New York",2870,145,2725,0.95,0.05
36081014300,"Census Tract 143, Queens County, New York",4007,2107,1900,0.47,0.53
36081014400,"Census Tract 144, Queens County, New York",2005,120,1885,0.94,0.06
36081014500,"Census Tract 145, Queens County, New York",2368,1440,928,0.39,0.61
36081014700,"Census Tract 147, Queens County, New York",2933,1764,1169,0.4,0.6
36081014800,"Census Tract 148, Queens County, New York",2186,73,2113,0.97,0.03
36081014900,"Census Tract 149, Queens County, New York",2477,1253,1224,0.49,0.51
36081015000,"Census Tract 150, Queens County, New York",2418,82,2336,0.97,0.03
36081015100,"Census Tract 151, Queens County, New York",2675,1455,1220,0.46,0.54
36081015200,"Census Tract 152, Queens County, New York",2638,101,2537,0.96,0.04
36081015300,"Census Tract 153, Queens County, New York",2131,1138,993,0.47,0.53
36081015400,"Census Tract 154, Queens County, New York",2390,103,2287,0.96,0.04
36081015500,"Census Tract 155, Queens County, New York",2344,1261,1083,0.46,0.54
36081015600,"Census Tract 156, Queens County, New York",3210,64,3146,0.98,0.02
36081015700,"Census Tract 157, Queens County, New York",1655,599,1056,0.64,0.36
36081015801,"Census Tract 158.01, Queens County, New York",3817,58,3759,0.98,0.02
36081015802,"Census Tract 158.02, Queens County, New York",4607,107,4500,0.98,0.02
36081015900,"Census Tract 159, Queens County, New York",4010,2102,1908,0.48,0.52
36081016100,"Census Tract 161, Queens County, New York",2291,725,1566,0.68,0.32
36081016300,"Census Tract 163, Queens County, New York",4053,590,3463,0.85,0.15
36081016400,"Census Tract 164, Queens County, New York",3306,54,3252,0.98,0.02
36081016600,"Census Tract 166, Queens County, New York",3400,92,3308,0.97,0.03
36081016800,"Census Tract 168, Queens County, New York",2764,81,2683,0.97,0.03
36081016900,"Census Tract 169, Queens County, New York",5577,2567,3010,0.54,0.46
36081017000,"Census Tract 170, Queens County, New York",2504,68,2436,0.97,0.03
36081017101,"Census Tract 171.01, Queens County, New York",36,8,28,0.78,0.22
36081017102,"Census Tract 171.02, Queens County, New York",27,1,26,0.96,0.04
36081017200,"Census Tract 172, Queens County, New York",2224,26,2198,0.99,0.01
36081017400,"Census Tract 174, Queens County, New York",2423,38,2385,0.98,0.02
36081017600,"Census Tract 176, Queens County, New York",2181,54,2127,0.98,0.02
36081017800,"Census Tract 178, Queens County, New York",2084,26,2058,0.99,0.01
36081017901,"Census Tract 179.01, Queens County, New York",986,317,669,0.68,0.32
36081017902,"Census Tract 179.02, Queens County, New York",124,26,98,0.79,0.21
36081018000,"Census Tract 180, Queens County, New York",1365,96,1269,0.93,0.07
36081018101,"Census Tract 181.01, Queens County, New York",3836,1310,2526,0.66,0.34
36081018102,"Census Tract 181.02, Queens County, New York",3800,1827,1973,0.52,0.48
36081018200,"Census Tract 182, Queens County, New York",2540,63,2477,0.98,0.02
36081018300,"Census Tract 183, Queens County, New York",6044,2437,3607,0.6,0.4
36081018401,"Census Tract 184.01, Queens County, New York",2174,13,2161,0.99,0.01
36081018402,"Census Tract 184.02, Queens County, New York",2412,18,2394,0.99,0.01
36081018501,"Census Tract 185.01, Queens County, New York",3502,1340,2162,0.62,0.38
36081018502,"Census Tract 185.02, Queens County, New York",3453,1361,2092,0.61,0.39
36081018600,"Census Tract 186, Queens County, New York",1802,48,1754,0.97,0.03
36081018700,"Census Tract 187, Queens County, New York",3611,943,2668,0.74,0.26
36081018800,"Census Tract 188, Queens County, New York",1510,17,1493,0.99,0.01
36081018900,"Census Tract 189, Queens County, New York",3457,947,2510,0.73,0.27
36081019000,"Census Tract 190, Queens County, New York",2445,56,2389,0.98,0.02
36081019200,"Census Tract 192, Queens County, New York",2359,42,2317,0.98,0.02
36081019400,"Census Tract 194, Queens County, New York",3015,35,2980,0.99,0.01
36081019600,"Census Tract 196, Queens County, New York",3122,31,3091,0.99,0.01
36081019800,"Census Tract 198, Queens County, New York",3682,33,3649,0.99,0.01
36081019901,"Census Tract 199.01, Queens County, New York",1088,125,963,0.89,0.11
36081019902,"Census Tract 199.02, Queens County, New York",317,38,279,0.88,0.12
36081019903,"Census Tract 199.03, Queens County, New York",0,0,0,0,0
36081020200,"Census Tract 202, Queens County, New York",1693,40,1653,0.98,0.02
36081020400,"Census Tract 204, Queens County, New York",2278,51,2227,0.98,0.02
36081020500,"Census Tract 205, Queens County, New York",1184,185,999,0.84,0.16
36081020600,"Census Tract 206, Queens County, New York",2046,114,1932,0.94,0.06
36081020800,"Census Tract 208, Queens County, New York",3513,279,3234,0.92,0.08
36081021200,"Census Tract 212, Queens County, New York",2812,134,2678,0.95,0.05
36081021400,"Census Tract 214, Queens County, New York",6673,677,5996,0.9,0.1
36081021601,"Census Tract 216.01, Queens County, New York",2678,1008,1670,0.62,0.38
36081021602,"Census Tract 216.02, Queens County, New York",1506,145,1361,0.9,0.1
36081021603,"Census Tract 216.03, Queens County, New York",0,0,0,0,0
36081021900,"Census Tract 219, Queens County, New York",31,10,21,0.68,0.32
36081022001,"Census Tract 220.01, Queens County, New York",6551,1662,4889,0.75,0.25
36081022002,"Census Tract 220.02, Queens County, New York",6010,1831,4179,0.7,0.3
36081022900,"Census Tract 229, Queens County, New York",0,0,0,0,0
36081023000,"Census Tract 230, Queens County, New York",1880,406,1474,0.78,0.22
36081023200,"Census Tract 232, Queens County, New York",5264,774,4490,0.85,0.15
36081023501,"Census Tract 235.01, Queens County, New York",4403,366,4037,0.92,0.08
36081023502,"Census Tract 235.02, Queens County, New York",3373,442,2931,0.87,0.13
36081023600,"Census Tract 236, Queens County, New York",3266,185,3081,0.94,0.06
36081023800,"Census Tract 238, Queens County, New York",4863,85,4778,0.98,0.02
36081024000,"Census Tract 240, Queens County, New York",6252,189,6063,0.97,0.03
36081024300,"Census Tract 243, Queens County, New York",6231,1062,5169,0.83,0.17
36081024500,"Census Tract 245, Queens County, New York",5544,1717,3827,0.69,0.31
36081024600,"Census Tract 246, Queens County, New York",1,1,0,0,1
36081024700,"Census Tract 247, Queens County, New York",1537,178,1359,0.88,0.12
36081024900,"Census Tract 249, Queens County, New York",5724,1146,4578,0.8,0.2
36081025100,"Census Tract 251, Queens County, New York",5818,1596,4222,0.73,0.27
36081025301,"Census Tract 253.01, Queens County, New York",4510,1488,3022,0.67,0.33
36081025302,"Census Tract 253.02, Queens County, New York",3013,676,2337,0.78,0.22
36081025401,"Census Tract 254.01, Queens County, New York",3899,29,3870,0.99,0.01
36081025402,"Census Tract 254.02, Queens County, New York",6180,129,6051,0.98,0.02
36081025500,"Census Tract 255, Queens County, New York",1603,363,1240,0.77,0.23
36081025700,"Census Tract 257, Queens County, New York",1648,258,1390,0.84,0.16
36081025800,"Census Tract 258, Queens County, New York",2289,11,2278,1,0
36081025900,"Census Tract 259, Queens County, New York",3542,449,3093,0.87,0.13
36081026000,"Census Tract 260, Queens County, New York",2915,36,2879,0.99,0.01
36081026100,"Census Tract 261, Queens County, New York",7802,522,7280,0.93,0.07
36081026200,"Census Tract 262, Queens County, New York",1652,8,1644,1,0
36081026300,"Census Tract 263, Queens County, New York",6631,543,6088,0.92,0.08
36081026400,"Census Tract 264, Queens County, New York",2736,21,2715,0.99,0.01
36081026501,"Census Tract 265.01, Queens County, New York",3213,234,2979,0.93,0.07
36081026502,"Census Tract 265.02, Queens County, New York",1622,84,1538,0.95,0.05
36081026600,"Census Tract 266, Queens County, New York",1949,25,1924,0.99,0.01
36081026700,"Census Tract 267, Queens County, New York",6196,279,5917,0.95,0.05
36081026901,"Census Tract 269.01, Queens County, New York",5210,182,5028,0.97,0.03
36081026902,"Census Tract 269.02, Queens County, New York",4244,181,4063,0.96,0.04
36081027000,"Census Tract 270, Queens County, New York",1960,26,1934,0.99,0.01
36081027101,"Census Tract 271.01, Queens County, New York",5454,207,5247,0.96,0.04
36081027102,"Census Tract 271.02, Queens County, New York",3112,188,2924,0.94,0.06
36081027200,"Census Tract 272, Queens County, New York",2065,34,2031,0.98,0.02
36081027301,"Census Tract 273.01, Queens County, New York",3673,75,3598,0.98,0.02
36081027302,"Census Tract 273.02, Queens County, New York",4765,211,4554,0.96,0.04
36081027400,"Census Tract 274, Queens County, New York",1927,10,1917,0.99,0.01
36081027500,"Census Tract 275, Queens County, New York",6773,539,6234,0.92,0.08
36081027600,"Census Tract 276, Queens County, New York",1365,9,1356,0.99,0.01
36081027701,"Census Tract 277.01, Queens County, New York",3448,195,3253,0.94,0.06
36081027702,"Census Tract 277.02, Queens County, New York",5196,587,4609,0.89,0.11
36081027800,"Census Tract 278, Queens County, New York",2529,39,2490,0.98,0.02
36081027900,"Census Tract 279, Queens County, New York",6358,973,5385,0.85,0.15
36081028000,"Census Tract 280, Queens County, New York",1901,5,1896,1,0
36081028100,"Census Tract 281, Queens County, New York",5991,1391,4600,0.77,0.23
36081028200,"Census Tract 282, Queens County, New York",1801,24,1777,0.99,0.01
36081028300,"Census Tract 283, Queens County, New York",7523,1528,5995,0.8,0.2
36081028400,"Census Tract 284, Queens County, New York",3766,46,3720,0.99,0.01
36081028500,"Census Tract 285, Queens County, New York",4858,1911,2947,0.61,0.39
36081028700,"Census Tract 287, Queens County, New York",6544,1701,4843,0.74,0.26
36081028801,"Census Tract 288.01, Queens County, New York",2940,51,2889,0.98,0.02
36081028802,"Census Tract 288.02, Queens County, New York",1952,14,1938,0.99,0.01
36081028803,"Census Tract 288.03, Queens County, New York",8,0,8,1,0
36081028900,"Census Tract 289, Queens County, New York",5202,1044,4158,0.8,0.2
36081029100,"Census Tract 291, Queens County, New York",7341,889,6452,0.88,0.12
36081029300,"Census Tract 293, Queens County, New York",1457,119,1338,0.92,0.08
36081029400,"Census Tract 294, Queens County, New York",8072,139,7933,0.98,0.02
36081029500,"Census Tract 295, Queens County, New York",3826,1419,2407,0.63,0.37
36081029700,"Census Tract 297, Queens County, New York",2258,762,1496,0.66,0.34
36081029900,"Census Tract 299, Queens County, New York",5,0,5,1,0
36081030600,"Census Tract 306, Queens County, New York",5287,109,5178,0.98,0.02
36081030903,"Census Tract 309.03, Queens County, New York",6748,720,6028,0.89,0.11
36081030904,"Census Tract 309.04, Queens County, New York",3724,826,2898,0.78,0.22
36081030905,"Census Tract 309.05, Queens County, New York",3424,717,2707,0.79,0.21
36081030906,"Census Tract 309.06, Queens County, New York",4924,686,4238,0.86,0.14
36081031700,"Census Tract 317, Queens County, New York",6781,4259,2522,0.37,0.63
36081032000,"Census Tract 320, Queens County, New York",5200,165,5035,0.97,0.03
36081032700,"Census Tract 327, Queens County, New York",3932,388,3544,0.9,0.1
36081032800,"Census Tract 328, Queens County, New York",2660,59,2601,0.98,0.02
36081032900,"Census Tract 329, Queens County, New York",4251,441,3810,0.9,0.1
36081033000,"Census Tract 330, Queens County, New York",7365,109,7256,0.99,0.01
36081033100,"Census Tract 331, Queens County, New York",0,0,0,0,0
36081033401,"Census Tract 334.01, Queens County, New York",4196,41,4155,0.99,0.01
36081033403,"Census Tract 334.03, Queens County, New York",4874,17,4857,1,0
36081033404,"Census Tract 334.04, Queens County, New York",4723,34,4689,0.99,0.01
36081033405,"Census Tract 334.05, Queens County, New York",3653,13,3640,1,0
36081033700,"Census Tract 337, Queens County, New York",3765,187,3578,0.95,0.05
36081033900,"Census Tract 339, Queens County, New York",3481,325,3156,0.91,0.09
36081034700,"Census Tract 347, Queens County, New York",3688,241,3447,0.93,0.07
36081035100,"Census Tract 351, Queens County, New York",4178,413,3765,0.9,0.1
36081035200,"Census Tract 352, Queens County, New York",2550,14,2536,0.99,0.01
36081035300,"Census Tract 353, Queens County, New York",2828,85,2743,0.97,0.03
36081035700,"Census Tract 357, Queens County, New York",5593,514,5079,0.91,0.09
36081035800,"Census Tract 358, Queens County, New York",4508,40,4468,0.99,0.01
36081036100,"Census Tract 361, Queens County, New York",2706,103,2603,0.96,0.04
36081036300,"Census Tract 363, Queens County, New York",2462,86,2376,0.97,0.03
36081036500,"Census Tract 365, Queens County, New York",4142,39,4103,0.99,0.01
36081036600,"Census Tract 366, Queens County, New York",3003,27,2976,0.99,0.01
36081036700,"Census Tract 367, Queens County, New York",3099,93,3006,0.97,0.03
36081036800,"Census Tract 368, Queens County, New York",2513,9,2504,1,0
36081037100,"Census Tract 371, Queens County, New York",1917,106,1811,0.94,0.06
36081037300,"Census Tract 373, Queens County, New York",2887,50,2837,0.98,0.02
36081037501,"Census Tract 375.01, Queens County, New York",1479,24,1455,0.98,0.02
36081037502,"Census Tract 375.02, Queens County, New York",2778,64,2714,0.98,0.02
36081037600,"Census Tract 376, Queens County, New York",6373,64,6309,0.99,0.01
36081037700,"Census Tract 377, Queens County, New York",4493,51,4442,0.99,0.01
36081037900,"Census Tract 379, Queens County, New York",6504,72,6432,0.99,0.01
36081038100,"Census Tract 381, Queens County, New York",6966,90,6876,0.99,0.01
36081038301,"Census Tract 383.01, Queens County, New York",2,0,2,1,0
36081038302,"Census Tract 383.02, Queens County, New York",44,3,41,0.93,0.07
36081038400,"Census Tract 384, Queens County, New York",2720,22,2698,0.99,0.01
36081039400,"Census Tract 394, Queens County, New York",3332,36,3296,0.99,0.01
36081039800,"Census Tract 398, Queens County, New York",1688,22,1666,0.99,0.01
36081039901,"Census Tract 399.01, Queens County, New York",2875,61,2814,0.98,0.02
36081039902,"Census Tract 399.02, Queens County, New York",2285,86,2199,0.96,0.04
36081040000,"Census Tract 400, Queens County, New York",1474,7,1467,1,0
36081040101,"Census Tract 401.01, Queens County, New York",2847,44,2803,0.98,0.02
36081040102,"Census Tract 401.02, Queens County, New York",4808,22,4786,1,0
36081040200,"Census Tract 402, Queens County, New York",1474,9,1465,0.99,0.01
36081040301,"Census Tract 403.01, Queens County, New York",2768,42,2726,0.98,0.02
36081040302,"Census Tract 403.02, Queens County, New York",4760,58,4702,0.99,0.01
36081040400,"Census Tract 404, Queens County, New York",4270,58,4212,0.99,0.01
36081040501,"Census Tract 405.01, Queens County, New York",1183,48,1135,0.96,0.04
36081040502,"Census Tract 405.02, Queens County, New York",2175,35,2140,0.98,0.02
36081040701,"Census Tract 407.01, Queens County, New York",3162,36,3126,0.99,0.01
36081040702,"Census Tract 407.02, Queens County, New York",5131,28,5103,0.99,0.01
36081040901,"Census Tract 409.01, Queens County, New York",1951,38,1913,0.98,0.02
36081040902,"Census Tract 409.02, Queens County, New York",3534,53,3481,0.99,0.01
36081041100,"Census Tract 411, Queens County, New York",4532,74,4458,0.98,0.02
36081041300,"Census Tract 413, Queens County, New York",4752,154,4598,0.97,0.03
36081041400,"Census Tract 414, Queens County, New York",4526,39,4487,0.99,0.01
36081041500,"Census Tract 415, Queens County, New York",4365,195,4170,0.96,0.04
36081042400,"Census Tract 424, Queens County, New York",2295,19,2276,0.99,0.01
36081042600,"Census Tract 426, Queens County, New York",364,121,243,0.67,0.33
36081042700,"Census Tract 427, Queens County, New York",4998,226,4772,0.95,0.05
36081043200,"Census Tract 432, Queens County, New York",1280,26,1254,0.98,0.02
36081043400,"Census Tract 434, Queens County, New York",1717,13,1704,0.99,0.01
36081043701,"Census Tract 437.01, Queens County, New York",3683,451,3232,0.88,0.12
36081043702,"Census Tract 437.02, Queens County, New York",6998,425,6573,0.94,0.06
36081043900,"Census Tract 439, Queens County, New York",4931,167,4764,0.97,0.03
36081044000,"Census Tract 440, Queens County, New York",4783,51,4732,0.99,0.01
36081044301,"Census Tract 443.01, Queens County, New York",4725,202,4523,0.96,0.04
36081044302,"Census Tract 443.02, Queens County, New York",5373,136,5237,0.97,0.03
36081044400,"Census Tract 444, Queens County, New York",4562,127,4435,0.97,0.03
36081044601,"Census Tract 446.01, Queens County, New York",4013,119,3894,0.97,0.03
36081044602,"Census Tract 446.02, Queens County, New York",5472,188,5284,0.97,0.03
36081044800,"Census Tract 448, Queens County, New York",3063,204,2859,0.93,0.07
36081045000,"Census Tract 450, Queens County, New York",2070,314,1756,0.85,0.15
36081045200,"Census Tract 452, Queens County, New York",1209,240,969,0.8,0.2
36081045400,"Census Tract 454, Queens County, New York",5207,204,5003,0.96,0.04
36081045500,"Census Tract 455, Queens County, New York",13200,1558,11642,0.88,0.12
36081045600,"Census Tract 456, Queens County, New York",1365,101,1264,0.93,0.07
36081045700,"Census Tract 457, Queens County, New York",3536,184,3352,0.95,0.05
36081045800,"Census Tract 458, Queens County, New York",2271,142,2129,0.94,0.06
36081045900,"Census Tract 459, Queens County, New York",4150,174,3976,0.96,0.04
36081046000,"Census Tract 460, Queens County, New York",6193,96,6097,0.98,0.02
36081046100,"Census Tract 461, Queens County, New York",2903,76,2827,0.97,0.03
36081046200,"Census Tract 462, Queens County, New York",8206,231,7975,0.97,0.03
36081046300,"Census Tract 463, Queens County, New York",4541,87,4454,0.98,0.02
36081046400,"Census Tract 464, Queens County, New York",1841,344,1497,0.81,0.19
36081046500,"Census Tract 465, Queens County, New York",4276,93,4183,0.98,0.02
36081046600,"Census Tract 466, Queens County, New York",3676,411,3265,0.89,0.11
36081046700,"Census Tract 467, Queens County, New York",7281,227,7054,0.97,0.03
36081046800,"Census Tract 468, Queens County, New York",4173,148,4025,0.96,0.04
36081046901,"Census Tract 469.01, Queens County, New York",4346,167,4179,0.96,0.04
36081046902,"Census Tract 469.02, Queens County, New York",4102,99,4003,0.98,0.02
36081047000,"Census Tract 470, Queens County, New York",3343,54,3289,0.98,0.02
36081047100,"Census Tract 471, Queens County, New York",4785,163,4622,0.97,0.03
36081047200,"Census Tract 472, Queens County, New York",3861,564,3297,0.85,0.15
36081047300,"Census Tract 473, Queens County, New York",4863,405,4458,0.92,0.08
36081047500,"Census Tract 475, Queens County, New York",5489,344,5145,0.94,0.06
36081047600,"Census Tract 476, Queens County, New York",1374,576,798,0.58,0.42
36081047801,"Census Tract 478.01, Queens County, New York",4065,591,3474,0.85,0.15
36081047802,"Census Tract 478.02, Queens County, New York",1511,48,1463,0.97,0.03
36081047900,"Census Tract 479, Queens County, New York",6837,497,6340,0.93,0.07
36081048000,"Census Tract 480, Queens County, New York",2666,102,2564,0.96,0.04
36081048100,"Census Tract 481, Queens County, New York",6321,273,6048,0.96,0.04
36081048200,"Census Tract 482, Queens County, New York",1518,57,1461,0.96,0.04
36081048301,"Census Tract 483.01, Queens County, New York",2145,150,1995,0.93,0.07
36081048302,"Census Tract 483.02, Queens County, New York",2092,213,1879,0.9,0.1
36081048400,"Census Tract 484, Queens County, New York",5569,131,5438,0.98,0.02
36081048500,"Census Tract 485, Queens County, New York",5331,293,5038,0.95,0.05
36081048900,"Census Tract 489, Queens County, New York",1937,247,1690,0.87,0.13
36081049201,"Census Tract 492.01, Queens County, New York",2888,150,2738,0.95,0.05
36081049202,"Census Tract 492.02, Queens County, New York",2018,95,1923,0.95,0.05
36081049301,"Census Tract 493.01, Queens County, New York",2391,727,1664,0.7,0.3
36081049302,"Census Tract 493.02, Queens County, New York",3498,1158,2340,0.67,0.33
36081049500,"Census Tract 495, Queens County, New York",1430,688,742,0.52,0.48
36081049600,"Census Tract 496, Queens County, New York",3251,81,3170,0.98,0.02
36081049700,"Census Tract 497, Queens County, New York",3381,933,2448,0.72,0.28
36081049900,"Census Tract 499, Queens County, New York",5477,716,4761,0.87,0.13
36081050000,"Census Tract 500, Queens County, New York",4778,166,4612,0.97,0.03
36081050201,"Census Tract 502.01, Queens County, New York",1678,32,1646,0.98,0.02
36081050202,"Census Tract 502.02, Queens County, New York",1521,36,1485,0.98,0.02
36081050400,"Census Tract 504, Queens County, New York",1872,26,1846,0.99,0.01
36081050500,"Census Tract 505, Queens County, New York",1768,476,1292,0.73,0.27
36081050600,"Census Tract 506, Queens County, New York",1635,33,1602,0.98,0.02
36081050700,"Census Tract 507, Queens County, New York",3699,1710,1989,0.54,0.46
36081050800,"Census Tract 508, Queens County, New York",2084,38,2046,0.98,0.02
36081051000,"Census Tract 510, Queens County, New York",1616,15,1601,0.99,0.01
36081051100,"Census Tract 511, Queens County, New York",2494,1172,1322,0.53,0.47
36081051200,"Census Tract 512, Queens County, New York",2748,41,2707,0.99,0.01
36081051300,"Census Tract 513, Queens County, New York",2638,999,1639,0.62,0.38
36081051500,"Census Tract 515, Queens County, New York",3126,1802,1324,0.42,0.58
36081051600,"Census Tract 516, Queens County, New York",2069,14,2055,0.99,0.01
36081051700,"Census Tract 517, Queens County, New York",2146,1318,828,0.39,0.61
36081051800,"Census Tract 518, Queens County, New York",1948,13,1935,0.99,0.01
36081052000,"Census Tract 520, Queens County, New York",1593,10,1583,0.99,0.01
36081052100,"Census Tract 521, Queens County, New York",2197,1208,989,0.45,0.55
36081052200,"Census Tract 522, Queens County, New York",1605,22,1583,0.99,0.01
36081052400,"Census Tract 524, Queens County, New York",1945,16,1929,0.99,0.01
36081052500,"Census Tract 525, Queens County, New York",2252,1096,1156,0.51,0.49
36081052600,"Census Tract 526, Queens County, New York",1958,16,1942,0.99,0.01
36081052800,"Census Tract 528, Queens County, New York",1563,17,1546,0.99,0.01
36081053000,"Census Tract 530, Queens County, New York",2393,16,2377,0.99,0.01
36081053100,"Census Tract 531, Queens County, New York",3462,1786,1676,0.48,0.52
36081053200,"Census Tract 532, Queens County, New York",1886,34,1852,0.98,0.02
36081053401,"Census Tract 534.01, Queens County, New York",2104,15,2089,0.99,0.01
36081053501,"Census Tract 535.01, Queens County, New York",1058,336,722,0.68,0.32
36081053502,"Census Tract 535.02, Queens County, New York",0,0,0,0,0
36081053601,"Census Tract 536.01, Queens County, New York",1578,13,1565,0.99,0.01
36081053800,"Census Tract 538, Queens County, New York",1648,14,1634,0.99,0.01
36081053901,"Census Tract 539.01, Queens County, New York",3968,1174,2794,0.7,0.3
36081053902,"Census Tract 539.02, Queens County, New York",88,48,40,0.45,0.55
36081054000,"Census Tract 540, Queens County, New York",4632,96,4536,0.98,0.02
36081054200,"Census Tract 542, Queens County, New York",5149,233,4916,0.95,0.05
36081054500,"Census Tract 545, Queens County, New York",3648,904,2744,0.75,0.25
36081054700,"Census Tract 547, Queens County, New York",4166,975,3191,0.77,0.23
36081054800,"Census Tract 548, Queens County, New York",2336,74,2262,0.97,0.03
36081054900,"Census Tract 549, Queens County, New York",4932,1239,3693,0.75,0.25
36081055100,"Census Tract 551, Queens County, New York",4574,1869,2705,0.59,0.41
36081055200,"Census Tract 552, Queens County, New York",3174,179,2995,0.94,0.06
36081055300,"Census Tract 553, Queens County, New York",2856,658,2198,0.77,0.23
36081055400,"Census Tract 554, Queens County, New York",2487,239,2248,0.9,0.1
36081055500,"Census Tract 555, Queens County, New York",1935,324,1611,0.83,0.17
36081055600,"Census Tract 556, Queens County, New York",2242,160,2082,0.93,0.07
36081055700,"Census Tract 557, Queens County, New York",3966,1165,2801,0.71,0.29
36081055800,"Census Tract 558, Queens County, New York",1710,146,1564,0.91,0.09
36081055900,"Census Tract 559, Queens County, New York",1178,210,968,0.82,0.18
36081056000,"Census Tract 560, Queens County, New York",1743,204,1539,0.88,0.12
36081056100,"Census Tract 561, Queens County, New York",20,10,10,0.5,0.5
36081056200,"Census Tract 562, Queens County, New York",1460,172,1288,0.88,0.12
36081056400,"Census Tract 564, Queens County, New York",1559,189,1370,0.88,0.12
36081056500,"Census Tract 565, Queens County, New York",1681,219,1462,0.87,0.13
36081056600,"Census Tract 566, Queens County, New York",1581,124,1457,0.92,0.08
36081056700,"Census Tract 567, Queens County, New York",4751,1671,3080,0.65,0.35
36081056800,"Census Tract 568, Queens County, New York",4862,216,4646,0.96,0.04
36081057700,"Census Tract 577, Queens County, New York",4023,1799,2224,0.55,0.45
36081057900,"Census Tract 579, Queens County, New York",1743,796,947,0.54,0.46
36081058000,"Census Tract 580, Queens County, New York",3589,60,3529,0.98,0.02
36081058100,"Census Tract 581, Queens County, New York",2785,1424,1361,0.49,0.51
36081058200,"Census Tract 582, Queens County, New York",4509,106,4403,0.98,0.02
36081058300,"Census Tract 583, Queens County, New York",3362,1755,1607,0.48,0.52
36081058500,"Census Tract 585, Queens County, New York",4128,2041,2087,0.51,0.49
36081058700,"Census Tract 587, Queens County, New York",3336,2015,1321,0.4,0.6
36081058900,"Census Tract 589, Queens County, New York",4308,2202,2106,0.49,0.51
36081059000,"Census Tract 590, Queens County, New York",1182,20,1162,0.98,0.02
36081059100,"Census Tract 591, Queens County, New York",5226,2014,3212,0.61,0.39
36081059200,"Census Tract 592, Queens County, New York",1186,30,1156,0.97,0.03
36081059300,"Census Tract 593, Queens County, New York",4092,2563,1529,0.37,0.63
36081059400,"Census Tract 594, Queens County, New York",1506,42,1464,0.97,0.03
36081059501,"Census Tract 595.01, Queens County, New York",2091,1099,992,0.47,0.53
36081059502,"Census Tract 595.02, Queens County, New York",2712,996,1716,0.63,0.37
36081059600,"Census Tract 596, Queens County, New York",1373,26,1347,0.98,0.02
36081059800,"Census Tract 598, Queens County, New York",1764,27,1737,0.98,0.02
36081059900,"Census Tract 599, Queens County, New York",1594,904,690,0.43,0.57
36081060000,"Census Tract 600, Queens County, New York",1223,19,1204,0.98,0.02
36081060100,"Census Tract 601, Queens County, New York",2414,1268,1146,0.47,0.53
36081060300,"Census Tract 603, Queens County, New York",1854,1044,810,0.44,0.56
36081060600,"Census Tract 606, Queens County, New York",1328,18,1310,0.99,0.01
36081060701,"Census Tract 607.01, Queens County, New York",3,3,0,0,1
36081060800,"Census Tract 608, Queens County, New York",1475,11,1464,0.99,0.01
36081061000,"Census Tract 610, Queens County, New York",1204,6,1198,1,0
36081061200,"Census Tract 612, Queens County, New York",1552,13,1539,0.99,0.01
36081061301,"Census Tract 613.01, Queens County, New York",5763,3164,2599,0.45,0.55
36081061302,"Census Tract 613.02, Queens County, New York",0,0,0,0,0
36081061400,"Census Tract 614, Queens County, New York",1205,22,1183,0.98,0.02
36081061601,"Census Tract 616.01, Queens County, New York",2095,11,2084,0.99,0.01
36081061602,"Census Tract 616.02, Queens County, New York",1402,29,1373,0.98,0.02
36081061800,"Census Tract 618, Queens County, New York",1736,31,1705,0.98,0.02
36081061900,"Census Tract 619, Queens County, New York",3097,1912,1185,0.38,0.62
36081062000,"Census Tract 620, Queens County, New York",1419,22,1397,0.98,0.02
36081062100,"Census Tract 621, Queens County, New York",3151,1689,1462,0.46,0.54
36081062200,"Census Tract 622, Queens County, New York",1979,23,1956,0.99,0.01
36081062300,"Census Tract 623, Queens County, New York",1923,1087,836,0.43,0.57
36081062400,"Census Tract 624, Queens County, New York",0,0,0,0,0
36081062500,"Census Tract 625, Queens County, New York",2625,1529,1096,0.42,0.58
36081062600,"Census Tract 626, Queens County, New York",2689,39,2650,0.99,0.01
36081062700,"Census Tract 627, Queens County, New York",3010,1604,1406,0.47,0.53
36081062900,"Census Tract 629, Queens County, New York",3042,1565,1477,0.49,0.51
36081063000,"Census Tract 630, Queens County, New York",1602,19,1583,0.99,0.01
36081063200,"Census Tract 632, Queens County, New York",2261,46,2215,0.98,0.02
36081063301,"Census Tract 633.01, Queens County, New York",1587,1039,548,0.35,0.65
36081063302,"Census Tract 633.02, Queens County, New York",1665,1086,579,0.35,0.65
36081063500,"Census Tract 635, Queens County, New York",2784,1689,1095,0.39,0.61
36081063700,"Census Tract 637, Queens County, New York",3507,2145,1362,0.39,0.61
36081063800,"Census Tract 638, Queens County, New York",3584,159,3425,0.96,0.04
36081063900,"Census Tract 639, Queens County, New York",2794,1496,1298,0.46,0.54
36081064101,"Census Tract 641.01, Queens County, New York",2378,1503,875,0.37,0.63
36081064102,"Census Tract 641.02, Queens County, New York",4,1,3,0.75,0.25
36081064500,"Census Tract 645, Queens County, New York",2064,843,1221,0.59,0.41
36081064600,"Census Tract 646, Queens County, New York",3025,37,2988,0.99,0.01
36081065000,"Census Tract 650, Queens County, New York",2831,29,2802,0.99,0.01
36081065401,"Census Tract 654.01, Queens County, New York",2836,113,2723,0.96,0.04
36081065402,"Census Tract 654.02, Queens County, New York",5,0,5,1,0
36081065501,"Census Tract 655.01, Queens County, New York",3,0,3,1,0
36081065600,"Census Tract 656, Queens County, New York",5423,136,5287,0.97,0.03
36081065702,"Census Tract 657.02, Queens County, New York",1775,1241,534,0.3,0.7
36081065703,"Census Tract 657.03, Queens County, New York",2829,2170,659,0.23,0.77
36081065900,"Census Tract 659, Queens County, New York",1850,1509,341,0.18,0.82
36081066000,"Census Tract 660, Queens County, New York",3511,143,3368,0.96,0.04
36081066100,"Census Tract 661, Queens County, New York",1573,1252,321,0.2,0.8
36081066301,"Census Tract 663.01, Queens County, New York",2713,1714,999,0.37,0.63
36081066302,"Census Tract 663.02, Queens County, New York",4,0,4,1,0
36081066401,"Census Tract 664.01, Queens County, New York",1923,99,1824,0.95,0.05
36081066402,"Census Tract 664.02, Queens County, New York",3942,148,3794,0.96,0.04
36081066403,"Census Tract 664.03, Queens County, New York",4480,103,4377,0.98,0.02
36081066404,"Census Tract 664.04, Queens County, New York",0,0,0,0,0
36081066501,"Census Tract 665.01, Queens County, New York",3538,2713,825,0.23,0.77
36081066701,"Census Tract 667.01, Queens County, New York",2789,1957,832,0.3,0.7
36081066900,"Census Tract 669, Queens County, New York",1790,1329,461,0.26,0.74
36081067100,"Census Tract 671, Queens County, New York",2248,1439,809,0.36,0.64
36081067700,"Census Tract 677, Queens County, New York",1832,1365,467,0.25,0.75
36081067900,"Census Tract 679, Queens County, New York",4397,1780,2617,0.6,0.4
36081068000,"Census Tract 680, Queens County, New York",5220,74,5146,0.99,0.01
36081068200,"Census Tract 682, Queens County, New York",1262,17,1245,0.99,0.01
36081068300,"Census Tract 683, Queens County, New York",4052,315,3737,0.92,0.08
36081068700,"Census Tract 687, Queens County, New York",4597,1290,3307,0.72,0.28
36081069000,"Census Tract 690, Queens County, New York",3787,33,3754,0.99,0.01
36081069300,"Census Tract 693, Queens County, New York",2887,928,1959,0.68,0.32
36081069400,"Census Tract 694, Queens County, New York",3604,48,3556,0.99,0.01
36081069500,"Census Tract 695, Queens County, New York",2451,977,1474,0.6,0.4
36081069701,"Census Tract 697.01, Queens County, New York",4435,1498,2937,0.66,0.34
36081069702,"Census Tract 697.02, Queens County, New York",3929,1542,2387,0.61,0.39
36081070300,"Census Tract 703, Queens County, New York",2225,892,1333,0.6,0.4
36081070700,"Census Tract 707, Queens County, New York",2426,1167,1259,0.52,0.48
36081070900,"Census Tract 709, Queens County, New York",2635,1063,1572,0.6,0.4
36081071100,"Census Tract 711, Queens County, New York",5687,2527,3160,0.56,0.44
36081071303,"Census Tract 713.03, Queens County, New York",5307,2862,2445,0.46,0.54
36081071304,"Census Tract 713.04, Queens County, New York",6386,3448,2938,0.46,0.54
36081071305,"Census Tract 713.05, Queens County, New York",5126,2431,2695,0.53,0.47
36081071306,"Census Tract 713.06, Queens County, New York",6181,2470,3711,0.6,0.4
36081071600,"Census Tract 716, Queens County, New York",2,0,2,1,0
36081071701,"Census Tract 717.01, Queens County, New York",5557,2429,3128,0.56,0.44
36081071702,"Census Tract 717.02, Queens County, New York",4660,1451,3209,0.69,0.31
36081071900,"Census Tract 719, Queens County, New York",2887,979,1908,0.66,0.34
36081072100,"Census Tract 721, Queens County, New York",5040,2399,2641,0.52,0.48
36081072300,"Census Tract 723, Queens County, New York",2158,1047,1111,0.51,0.49
36081072900,"Census Tract 729, Queens County, New York",1490,576,914,0.61,0.39
36081073100,"Census Tract 731, Queens County, New York",1550,784,766,0.49,0.51
36081073700,"Census Tract 737, Queens County, New York",2277,1183,1094,0.48,0.52
36081073900,"Census Tract 739, Queens County, New York",5548,3000,2548,0.46,0.54
36081074100,"Census Tract 741, Queens County, New York",3164,1633,1531,0.48,0.52
36081074300,"Census Tract 743, Queens County, New York",4433,2150,2283,0.52,0.48
36081074500,"Census Tract 745, Queens County, New York",3659,1693,1966,0.54,0.46
36081074700,"Census Tract 747, Queens County, New York",3539,947,2592,0.73,0.27
36081074900,"Census Tract 749, Queens County, New York",1563,853,710,0.45,0.55
36081075701,"Census Tract 757.01, Queens County, New York",5110,2161,2949,0.58,0.42
36081075702,"Census Tract 757.02, Queens County, New York",5071,2502,2569,0.51,0.49
36081076901,"Census Tract 769.01, Queens County, New York",4274,2278,1996,0.47,0.53
36081076902,"Census Tract 769.02, Queens County, New York",1390,576,814,0.59,0.41
36081077300,"Census Tract 773, Queens County, New York",2311,1091,1220,0.53,0.47
36081077500,"Census Tract 775, Queens County, New York",2241,1181,1060,0.47,0.53
36081077902,"Census Tract 779.02, Queens County, New York",5416,4182,1234,0.23,0.77
36081077903,"Census Tract 779.03, Queens County, New York",2937,1189,1748,0.6,0.4
36081077904,"Census Tract 779.04, Queens County, New York",6324,3169,3155,0.5,0.5
36081077905,"Census Tract 779.05, Queens County, New York",2586,854,1732,0.67,0.33
36081077906,"Census Tract 779.06, Queens County, New York",3968,1820,2148,0.54,0.46
36081077907,"Census Tract 779.07, Queens County, New York",3349,2266,1083,0.32,0.68
36081077908,"Census Tract 779.08, Queens County, New York",3838,811,3027,0.79,0.21
36081078800,"Census Tract 788, Queens County, New York",2002,31,1971,0.98,0.02
36081079000,"Census Tract 790, Queens County, New York",2875,52,2823,0.98,0.02
36081079200,"Census Tract 792, Queens County, New York",2717,39,2678,0.99,0.01
36081079300,"Census Tract 793, Queens County, New York",1,0,1,1,0
36081079701,"Census Tract 797.01, Queens County, New York",7620,364,7256,0.95,0.05
36081079702,"Census Tract 797.02, Queens County, New York",5002,151,4851,0.97,0.03
36081079900,"Census Tract 799, Queens County, New York",3871,294,3577,0.92,0.08
36081080301,"Census Tract 803.01, Queens County, New York",4828,448,4380,0.91,0.09
36081080302,"Census Tract 803.02, Queens County, New York",3973,544,3429,0.86,0.14
36081080900,"Census Tract 809, Queens County, New York",7591,2952,4639,0.61,0.39
36081081400,"Census Tract 814, Queens County, New York",4088,86,4002,0.98,0.02
36081081800,"Census Tract 818, Queens County, New York",3873,133,3740,0.97,0.03
36081083700,"Census Tract 837, Queens County, New York",6229,410,5819,0.93,0.07
36081083800,"Census Tract 838, Queens County, New York",5194,537,4657,0.9,0.1
36081084000,"Census Tract 840, Queens County, New York",6644,381,6263,0.94,0.06
36081084500,"Census Tract 845, Queens County, New York",5516,274,5242,0.95,0.05
36081084601,"Census Tract 846.01, Queens County, New York",3045,357,2688,0.88,0.12
36081084602,"Census Tract 846.02, Queens County, New York",1496,146,1350,0.9,0.1
36081084901,"Census Tract 849.01, Queens County, New York",3013,50,2963,0.98,0.02
36081084902,"Census Tract 849.02, Queens County, New York",4466,78,4388,0.98,0.02
36081085300,"Census Tract 853, Queens County, New York",5415,173,5242,0.97,0.03
36081085500,"Census Tract 855, Queens County, New York",6889,385,6504,0.94,0.06
36081085700,"Census Tract 857, Queens County, New York",5770,236,5534,0.96,0.04
36081085900,"Census Tract 859, Queens County, New York",6162,301,5861,0.95,0.05
36081086100,"Census Tract 861, Queens County, New York",2450,160,2290,0.93,0.07
36081086300,"Census Tract 863, Queens County, New York",7118,346,6772,0.95,0.05
36081086400,"Census Tract 864, Queens County, New York",2867,320,2547,0.89,0.11
36081086500,"Census Tract 865, Queens County, New York",5224,537,4687,0.9,0.1
36081086900,"Census Tract 869, Queens County, New York",2343,44,2299,0.98,0.02
36081087100,"Census Tract 871, Queens County, New York",6373,349,6024,0.95,0.05
36081088400,"Census Tract 884, Queens County, New York",7578,5255,2323,0.31,0.69
36081088902,"Census Tract 889.02, Queens County, New York",7015,482,6533,0.93,0.07
36081088903,"Census Tract 889.03, Queens County, New York",4487,888,3599,0.8,0.2
36081089201,"Census Tract 892.01, Queens County, New York",7404,6080,1324,0.18,0.82
36081089202,"Census Tract 892.02, Queens County, New York",0,0,0,0,0
36081090700,"Census Tract 907, Queens County, New York",1584,365,1219,0.77,0.23
36081091602,"Census Tract 916.02, Queens County, New York",12,6,6,0.5,0.5
36081091603,"Census Tract 916.03, Queens County, New York",4456,4213,243,0.05,0.95
36081091604,"Census Tract 916.04, Queens County, New York",0,0,0,0,0
36081091800,"Census Tract 918, Queens County, New York",12,11,1,0.08,0.92
36081091900,"Census Tract 919, Queens County, New York",6417,1070,5347,0.83,0.17
36081092200,"Census Tract 922, Queens County, New York",2208,2005,203,0.09,0.91
36081092500,"Census Tract 925, Queens County, New York",4356,613,3743,0.86,0.14
36081092800,"Census Tract 928, Queens County, New York",3204,2911,293,0.09,0.91
36081092900,"Census Tract 929, Queens County, New York",7638,1552,6086,0.8,0.2
36081093401,"Census Tract 934.01, Queens County, New York",3732,3224,508,0.14,0.86
36081093402,"Census Tract 934.02, Queens County, New York",3704,2657,1047,0.28,0.72
36081093800,"Census Tract 938, Queens County, New York",4460,2621,1839,0.41,0.59
36081093900,"Census Tract 939, Queens County, New York",6268,1100,5168,0.82,0.18
36081094201,"Census Tract 942.01, Queens County, New York",3729,1013,2716,0.73,0.27
36081094202,"Census Tract 942.02, Queens County, New York",4785,874,3911,0.82,0.18
36081094203,"Census Tract 942.03, Queens County, New York",5676,3017,2659,0.47,0.53
36081094500,"Census Tract 945, Queens County, New York",4327,1879,2448,0.57,0.43
36081094700,"Census Tract 947, Queens County, New York",3035,597,2438,0.8,0.2
36081095400,"Census Tract 954, Queens County, New York",6108,752,5356,0.88,0.12
36081096400,"Census Tract 964, Queens County, New York",6353,713,5640,0.89,0.11
36081097202,"Census Tract 972.02, Queens County, New York",3460,49,3411,0.99,0.01
36081097204,"Census Tract 972.04, Queens County, New York",4078,292,3786,0.93,0.07
36081097205,"Census Tract 972.05, Queens County, New York",4268,71,4197,0.98,0.02
36081097206,"Census Tract 972.06, Queens County, New York",2910,43,2867,0.99,0.01
36081097207,"Census Tract 972.07, Queens County, New York",12,0,12,1,0
36081097300,"Census Tract 973, Queens County, New York",2007,1448,559,0.28,0.72
36081098100,"Census Tract 981, Queens County, New York",2353,1317,1036,0.44,0.56
36081098700,"Census Tract 987, Queens County, New York",2543,1502,1041,0.41,0.59
36081099100,"Census Tract 991, Queens County, New York",6642,4655,1987,0.3,0.7
36081099200,"Census Tract 992, Queens County, New York",4348,261,4087,0.94,0.06
36081099701,"Census Tract 997.01, Queens County, New York",3075,1658,1417,0.46,0.54
36081099703,"Census Tract 997.03, Queens County, New York",3938,2232,1706,0.43,0.57
36081099704,"Census Tract 997.04, Queens County, New York",7280,3978,3302,0.45,0.55
36081099705,"Census Tract 997.05, Queens County, New York",2687,1133,1554,0.58,0.42
36081099801,"Census Tract 998.01, Queens County, New York",7853,368,7485,0.95,0.05
36081099802,"Census Tract 998.02, Queens County, New York",5822,1221,4601,0.79,0.21
36081099900,"Census Tract 999, Queens County, New York",0,0,0,0,0
36081100801,"Census Tract 1008.01, Queens County, New York",2496,913,1583,0.63,0.37
36081100803,"Census Tract 1008.03, Queens County, New York",4817,310,4507,0.94,0.06
36081100804,"Census Tract 1008.04, Queens County, New York",4315,1152,3163,0.73,0.27
36081101002,"Census Tract 1010.02, Queens County, New York",4596,3258,1338,0.29,0.71
36081101003,"Census Tract 1010.03, Queens County, New York",3943,1123,2820,0.72,0.28
36081101004,"Census Tract 1010.04, Queens County, New York",6612,2018,4594,0.69,0.31
36081101700,"Census Tract 1017, Queens County, New York",6307,3435,2872,0.46,0.54
36081102900,"Census Tract 1029, Queens County, New York",3786,1957,1829,0.48,0.52
36081103201,"Census Tract 1032.01, Queens County, New York",6986,188,6798,0.97,0.03
36081103202,"Census Tract 1032.02, Queens County, New York",6860,2946,3914,0.57,0.43
36081103300,"Census Tract 1033, Queens County, New York",4459,2295,2164,0.49,0.51
36081103900,"Census Tract 1039, Queens County, New York",6618,2600,4018,0.61,0.39
36081104700,"Census Tract 1047, Queens County, New York",7907,2250,5657,0.72,0.28
36081105900,"Census Tract 1059, Queens County, New York",3812,1902,1910,0.5,0.5
36081107201,"Census Tract 1072.01, Queens County, New York",2370,1959,411,0.17,0.83
36081107202,"Census Tract 1072.02, Queens County, New York",0,0,0,0,0
36081108500,"Census Tract 1085, Queens County, New York",2778,1128,1650,0.59,0.41
36081109300,"Census Tract 1093, Queens County, New York",3139,1561,1578,0.5,0.5
36081109700,"Census Tract 1097, Queens County, New York",1797,877,920,0.51,0.49
36081109900,"Census Tract 1099, Queens County, New York",3538,1252,2286,0.65,0.35
36081111300,"Census Tract 1113, Queens County, New York",2611,1070,1541,0.59,0.41
36081112300,"Census Tract 1123, Queens County, New York",2126,754,1372,0.65,0.35
36081112900,"Census Tract 1129, Queens County, New York",2248,1055,1193,0.53,0.47
36081113300,"Census Tract 1133, Queens County, New York",1554,802,752,0.48,0.52
36081113900,"Census Tract 1139, Queens County, New York",3602,1352,2250,0.62,0.38
36081114100,"Census Tract 1141, Queens County, New York",2580,1194,1386,0.54,0.46
36081114700,"Census Tract 1147, Queens County, New York",1833,755,1078,0.59,0.41
36081115100,"Census Tract 1151, Queens County, New York",1087,455,632,0.58,0.42
36081115500,"Census Tract 1155, Queens County, New York",2132,363,1769,0.83,0.17
36081115700,"Census Tract 1157, Queens County, New York",3529,400,3129,0.89,0.11
36081115900,"Census Tract 1159, Queens County, New York",3922,488,3434,0.88,0.12
36081116100,"Census Tract 1161, Queens County, New York",4585,316,4269,0.93,0.07
36081116301,"Census Tract 1163.01, Queens County, New York",5178,375,4803,0.93,0.07
36081116302,"Census Tract 1163.02, Queens County, New York",3461,188,3273,0.95,0.05
36081116700,"Census Tract 1167, Queens County, New York",2094,92,2002,0.96,0.04
36081117100,"Census Tract 1171, Queens County, New York",2837,427,2410,0.85,0.15
36081117500,"Census Tract 1175, Queens County, New York",5410,1249,4161,0.77,0.23
36081118100,"Census Tract 1181, Queens County, New York",2015,632,1383,0.69,0.31
36081118500,"Census Tract 1185, Queens County, New York",2357,245,2112,0.9,0.1
36081118700,"Census Tract 1187, Queens County, New York",2648,204,2444,0.92,0.08
36081118900,"Census Tract 1189, Queens County, New York",2625,211,2414,0.92,0.08
36081119100,"Census Tract 1191, Queens County, New York",3694,320,3374,0.91,0.09
36081119300,"Census Tract 1193, Queens County, New York",2407,395,2012,0.84,0.16
36081119500,"Census Tract 1195, Queens County, New York",1445,417,1028,0.71,0.29
36081119900,"Census Tract 1199, Queens County, New York",1699,226,1473,0.87,0.13
36081120100,"Census Tract 1201, Queens County, New York",1840,102,1738,0.94,0.06
36081120300,"Census Tract 1203, Queens County, New York",1818,142,1676,0.92,0.08
36081120500,"Census Tract 1205, Queens County, New York",3144,125,3019,0.96,0.04
36081120701,"Census Tract 1207.01, Queens County, New York",3058,681,2377,0.78,0.22
36081120702,"Census Tract 1207.02, Queens County, New York",3,0,3,1,0
36081121100,"Census Tract 1211, Queens County, New York",2,0,2,1,0
36081121500,"Census Tract 1215, Queens County, New York",4737,485,4252,0.9,0.1
36081122300,"Census Tract 1223, Queens County, New York",3822,964,2858,0.75,0.25
36081122702,"Census Tract 1227.02, Queens County, New York",6959,870,6089,0.87,0.13
36081122703,"Census Tract 1227.03, Queens County, New York",6801,1879,4922,0.72,0.28
36081122704,"Census Tract 1227.04, Queens County, New York",4444,964,3480,0.78,0.22
36081124100,"Census Tract 1241, Queens County, New York",4004,1191,2813,0.7,0.3
36081124700,"Census Tract 1247, Queens County, New York",3734,1665,2069,0.55,0.45
36081125700,"Census Tract 1257, Queens County, New York",3642,368,3274,0.9,0.1
36081126500,"Census Tract 1265, Queens County, New York",1595,376,1219,0.76,0.24
36081126700,"Census Tract 1267, Queens County, New York",4490,1742,2748,0.61,0.39
36081127700,"Census Tract 1277, Queens County, New York",3600,2579,1021,0.28,0.72
36081128300,"Census Tract 1283, Queens County, New York",5,0,5,1,0
36081129102,"Census Tract 1291.02, Queens County, New York",3561,1933,1628,0.46,0.54
36081129103,"Census Tract 1291.03, Queens County, New York",3811,1912,1899,0.5,0.5
36081129104,"Census Tract 1291.04, Queens County, New York",4318,1715,2603,0.6,0.4
36081130100,"Census Tract 1301, Queens County, New York",4203,758,3445,0.82,0.18
36081133300,"Census Tract 1333, Queens County, New York",3915,1719,2196,0.56,0.44
36081133900,"Census Tract 1339, Queens County, New York",1360,672,688,0.51,0.49
36081134100,"Census Tract 1341, Queens County, New York",3659,901,2758,0.75,0.25
36081134701,"Census Tract 1347.01, Queens County, New York",5561,840,4721,0.85,0.15
36081134702,"Census Tract 1347.02, Queens County, New York",5117,874,4243,0.83,0.17
36081136700,"Census Tract 1367, Queens County, New York",6250,1571,4679,0.75,0.25
36081137700,"Census Tract 1377, Queens County, New York",7309,1356,5953,0.81,0.19
36081138501,"Census Tract 1385.01, Queens County, New York",4994,972,4022,0.81,0.19
36081138502,"Census Tract 1385.02, Queens County, New York",85,63,22,0.26,0.74
36081139900,"Census Tract 1399, Queens County, New York",1769,553,1216,0.69,0.31
36081140300,"Census Tract 1403, Queens County, New York",2406,631,1775,0.74,0.26
36081140901,"Census Tract 1409.01, Queens County, New York",1020,254,766,0.75,0.25
36081140902,"Census Tract 1409.02, Queens County, New York",2906,608,2298,0.79,0.21
36081141700,"Census Tract 1417, Queens County, New York",4975,1069,3906,0.79,0.21
36081142900,"Census Tract 1429, Queens County, New York",3897,1348,2549,0.65,0.35
36081143500,"Census Tract 1435, Queens County, New York",2364,660,1704,0.72,0.28
36081144100,"Census Tract 1441, Queens County, New York",2957,925,2032,0.69,0.31
36081144700,"Census Tract 1447, Queens County, New York",3131,362,2769,0.88,0.12
36081145101,"Census Tract 1451.01, Queens County, New York",1501,553,948,0.63,0.37
36081145102,"Census Tract 1451.02, Queens County, New York",2597,527,2070,0.8,0.2
36081145900,"Census Tract 1459, Queens County, New York",2870,994,1876,0.65,0.35
36081146300,"Census Tract 1463, Queens County, New York",2929,933,1996,0.68,0.32
36081146700,"Census Tract 1467, Queens County, New York",2807,1148,1659,0.59,0.41
36081147100,"Census Tract 1471, Queens County, New York",3239,1140,2099,0.65,0.35
36081147900,"Census Tract 1479, Queens County, New York",4279,1656,2623,0.61,0.39
36081148300,"Census Tract 1483, Queens County, New York",2968,1639,1329,0.45,0.55
36081150701,"Census Tract 1507.01, Queens County, New York",2919,1524,1395,0.48,0.52
36081150702,"Census Tract 1507.02, Queens County, New York",3049,1334,1715,0.56,0.44
36081152901,"Census Tract 1529.01, Queens County, New York",6382,1900,4482,0.7,0.3
36081152902,"Census Tract 1529.02, Queens County, New York",5665,2287,3378,0.6,0.4
36081155101,"Census Tract 1551.01, Queens County, New York",1945,1808,137,0.07,0.93
36081155103,"Census Tract 1551.03, Queens County, New York",4373,2041,2332,0.53,0.47
36081155104,"Census Tract 1551.04, Queens County, New York",3616,1189,2427,0.67,0.33
36081156700,"Census Tract 1567, Queens County, New York",1470,168,1302,0.89,0.11
36081157101,"Census Tract 1571.01, Queens County, New York",7561,1595,5966,0.79,0.21
36081157102,"Census Tract 1571.02, Queens County, New York",2109,322,1787,0.85,0.15
36081157901,"Census Tract 1579.01, Queens County, New York",5184,1386,3798,0.73,0.27
36081157902,"Census Tract 1579.02, Queens County, New York",3757,758,2999,0.8,0.2
36081157903,"Census Tract 1579.03, Queens County, New York",4489,1152,3337,0.74,0.26
36081161700,"Census Tract 1617, Queens County, New York",4541,1494,3047,0.67,0.33
36081162100,"Census Tract 1621, Queens County, New York",6682,1093,5589,0.84,0.16
36081990100,"Census Tract 9901, Queens County, New York",0,0,0,0,0
36083040100,"Census Tract 401, Rensselaer County, New York",4017,2478,1539,0.38,0.62
36083040200,"Census Tract 402, Rensselaer County, New York",4279,2704,1575,0.37,0.63
36083040300,"Census Tract 403, Rensselaer County, New York",3350,1719,1631,0.49,0.51
36083040400,"Census Tract 404, Rensselaer County, New York",2531,792,1739,0.69,0.31
36083040500,"Census Tract 405, Rensselaer County, New York",2055,911,1144,0.56,0.44
36083040600,"Census Tract 406, Rensselaer County, New York",2286,1258,1028,0.45,0.55
36083040701,"Census Tract 407.01, Rensselaer County, New York",3786,2139,1647,0.44,0.56
36083040702,"Census Tract 407.02, Rensselaer County, New York",1629,938,691,0.42,0.58
36083040800,"Census Tract 408, Rensselaer County, New York",1731,1178,553,0.32,0.68
36083040900,"Census Tract 409, Rensselaer County, New York",2950,1560,1390,0.47,0.53
36083041000,"Census Tract 410, Rensselaer County, New York",4536,2084,2452,0.54,0.46
36083041101,"Census Tract 411.01, Rensselaer County, New York",3092,2404,688,0.22,0.78
36083041102,"Census Tract 411.02, Rensselaer County, New York",2682,1214,1468,0.55,0.45
36083041200,"Census Tract 412, Rensselaer County, New York",3269,2536,733,0.22,0.78
36083041300,"Census Tract 413, Rensselaer County, New York",5283,3510,1773,0.34,0.66
36083041400,"Census Tract 414, Rensselaer County, New York",3925,2794,1131,0.29,0.71
36083051500,"Census Tract 515, Rensselaer County, New York",2880,1869,1011,0.35,0.65
36083051601,"Census Tract 516.01, Rensselaer County, New York",2992,1825,1167,0.39,0.61
36083051602,"Census Tract 516.02, Rensselaer County, New York",3338,2523,815,0.24,0.76
36083051701,"Census Tract 517.01, Rensselaer County, New York",3495,3121,374,0.11,0.89
36083051702,"Census Tract 517.02, Rensselaer County, New York",3216,2913,303,0.09,0.91
36083051800,"Census Tract 518, Rensselaer County, New York",5540,5100,440,0.08,0.92
36083051901,"Census Tract 519.01, Rensselaer County, New York",3891,3530,361,0.09,0.91
36083051902,"Census Tract 519.02, Rensselaer County, New York",3554,3169,385,0.11,0.89
36083052002,"Census Tract 520.02, Rensselaer County, New York",1748,1631,117,0.07,0.93
36083052003,"Census Tract 520.03, Rensselaer County, New York",4326,3778,548,0.13,0.87
36083052004,"Census Tract 520.04, Rensselaer County, New York",6507,5632,875,0.13,0.87
36083052101,"Census Tract 521.01, Rensselaer County, New York",2051,1842,209,0.1,0.9
36083052102,"Census Tract 521.02, Rensselaer County, New York",1372,1277,95,0.07,0.93
36083052103,"Census Tract 521.03, Rensselaer County, New York",1808,1660,148,0.08,0.92
36083052201,"Census Tract 522.01, Rensselaer County, New York",4322,4012,310,0.07,0.93
36083052203,"Census Tract 522.03, Rensselaer County, New York",5919,5358,561,0.09,0.91
36083052204,"Census Tract 522.04, Rensselaer County, New York",2429,2240,189,0.08,0.92
36083052301,"Census Tract 523.01, Rensselaer County, New York",4822,3782,1040,0.22,0.78
36083052303,"Census Tract 523.03, Rensselaer County, New York",1117,1033,84,0.08,0.92
36083052305,"Census Tract 523.05, Rensselaer County, New York",2906,2639,267,0.09,0.91
36083052306,"Census Tract 523.06, Rensselaer County, New York",4447,3663,784,0.18,0.82
36083052402,"Census Tract 524.02, Rensselaer County, New York",2359,2090,269,0.11,0.89
36083052405,"Census Tract 524.05, Rensselaer County, New York",2522,2068,454,0.18,0.82
36083052406,"Census Tract 524.06, Rensselaer County, New York",4532,3471,1061,0.23,0.77
36083052407,"Census Tract 524.07, Rensselaer County, New York",4625,3752,873,0.19,0.81
36083052408,"Census Tract 524.08, Rensselaer County, New York",2710,2210,500,0.18,0.82
36083052501,"Census Tract 525.01, Rensselaer County, New York",6105,5428,677,0.11,0.89
36083052502,"Census Tract 525.02, Rensselaer County, New York",5327,4826,501,0.09,0.91
36083052503,"Census Tract 525.03, Rensselaer County, New York",1477,1280,197,0.13,0.87
36083052601,"Census Tract 526.01, Rensselaer County, New York",3498,3152,346,0.1,0.9
36083052602,"Census Tract 526.02, Rensselaer County, New York",1103,972,131,0.12,0.88
36083052603,"Census Tract 526.03, Rensselaer County, New York",2791,2535,256,0.09,0.91
36085000300,"Census Tract 3, Richmond County, New York",2348,953,1395,0.59,0.41
36085000600,"Census Tract 6, Richmond County, New York",2859,1459,1400,0.49,0.51
36085000700,"Census Tract 7, Richmond County, New York",5143,985,4158,0.81,0.19
36085000800,"Census Tract 8, Richmond County, New York",6268,2404,3864,0.62,0.38
36085000900,"Census Tract 9, Richmond County, New York",2240,376,1864,0.83,0.17
36085001100,"Census Tract 11, Richmond County, New York",4234,716,3518,0.83,0.17
36085001700,"Census Tract 17, Richmond County, New York",1865,599,1266,0.68,0.32
36085001800,"Census Tract 18, Richmond County, New York",495,238,257,0.52,0.48
36085002001,"Census Tract 20.01, Richmond County, New York",2524,1525,999,0.4,0.6
36085002002,"Census Tract 20.02, Richmond County, New York",3302,2166,1136,0.34,0.66
36085002100,"Census Tract 21, Richmond County, New York",5467,1236,4231,0.77,0.23
36085002700,"Census Tract 27, Richmond County, New York",2049,374,1675,0.82,0.18
36085002900,"Census Tract 29, Richmond County, New York",6871,417,6454,0.94,0.06
36085003300,"Census Tract 33, Richmond County, New York",3738,1408,2330,0.62,0.38
36085003600,"Census Tract 36, Richmond County, New York",2792,1011,1781,0.64,0.36
36085003900,"Census Tract 39, Richmond County, New York",2179,971,1208,0.55,0.45
36085004001,"Census Tract 40.01, Richmond County, New York",2775,380,2395,0.86,0.14
36085004002,"Census Tract 40.02, Richmond County, New York",3409,153,3256,0.96,0.04
36085004003,"Census Tract 40.03, Richmond County, New York",4851,92,4759,0.98,0.02
36085004004,"Census Tract 40.04, Richmond County, New York",2807,344,2463,0.88,0.12
36085004700,"Census Tract 47, Richmond County, New York",3126,1803,1323,0.42,0.58
36085005000,"Census Tract 50, Richmond County, New York",4357,2274,2083,0.48,0.52
36085005901,"Census Tract 59.01, Richmond County, New York",2854,2004,850,0.3,0.7
36085005902,"Census Tract 59.02, Richmond County, New York",5,0,5,1,0
36085006400,"Census Tract 64, Richmond County, New York",3698,1828,1870,0.51,0.49
36085006700,"Census Tract 67, Richmond County, New York",2927,2007,920,0.31,0.69
36085007001,"Census Tract 70.01, Richmond County, New York",2634,1697,937,0.36,0.64
36085007002,"Census Tract 70.02, Richmond County, New York",6215,3611,2604,0.42,0.58
36085007400,"Census Tract 74, Richmond County, New York",4962,2538,2424,0.49,0.51
36085007500,"Census Tract 75, Richmond County, New York",4200,1346,2854,0.68,0.32
36085007700,"Census Tract 77, Richmond County, New York",1762,178,1584,0.9,0.1
36085008100,"Census Tract 81, Richmond County, New York",4822,1186,3636,0.75,0.25
36085009601,"Census Tract 96.01, Richmond County, New York",4075,2816,1259,0.31,0.69
36085009602,"Census Tract 96.02, Richmond County, New York",3767,2526,1241,0.33,0.67
36085009701,"Census Tract 97.01, Richmond County, New York",4454,1433,3021,0.68,0.32
36085009702,"Census Tract 97.02, Richmond County, New York",8,7,1,0.13,0.88
36085010500,"Census Tract 105, Richmond County, New York",5597,1952,3645,0.65,0.35
36085011201,"Census Tract 112.01, Richmond County, New York",5768,3755,2013,0.35,0.65
36085011203,"Census Tract 112.03, Richmond County, New York",6791,4132,2659,0.39,0.61
36085011204,"Census Tract 112.04, Richmond County, New York",46,19,27,0.59,0.41
36085011401,"Census Tract 114.01, Richmond County, New York",3249,1458,1791,0.55,0.45
36085011402,"Census Tract 114.02, Richmond County, New York",3738,2450,1288,0.34,0.66
36085012100,"Census Tract 121, Richmond County, New York",3212,2539,673,0.21,0.79
36085012200,"Census Tract 122, Richmond County, New York",3938,3055,883,0.22,0.78
36085012500,"Census Tract 125, Richmond County, New York",3087,1120,1967,0.64,0.36
36085012804,"Census Tract 128.04, Richmond County, New York",4644,2882,1762,0.38,0.62
36085012805,"Census Tract 128.05, Richmond County, New York",2390,1757,633,0.26,0.74
36085012806,"Census Tract 128.06, Richmond County, New York",6659,4130,2529,0.38,0.62
36085013201,"Census Tract 132.01, Richmond County, New York",1659,1325,334,0.2,0.8
36085013203,"Census Tract 132.03, Richmond County, New York",5790,4536,1254,0.22,0.78
36085013204,"Census Tract 132.04, Richmond County, New York",5055,3803,1252,0.25,0.75
36085013301,"Census Tract 133.01, Richmond County, New York",1631,90,1541,0.94,0.06
36085013302,"Census Tract 133.02, Richmond County, New York",3733,376,3357,0.9,0.1
36085013400,"Census Tract 134, Richmond County, New York",4204,2875,1329,0.32,0.68
36085013800,"Census Tract 138, Richmond County, New York",6625,5307,1318,0.2,0.8
36085014100,"Census Tract 141, Richmond County, New York",2868,827,2041,0.71,0.29
36085014604,"Census Tract 146.04, Richmond County, New York",6651,5287,1364,0.21,0.79
36085014605,"Census Tract 146.05, Richmond County, New York",3785,3165,620,0.16,0.84
36085014606,"Census Tract 146.06, Richmond County, New York",6288,5039,1249,0.2,0.8
36085014607,"Census Tract 146.07, Richmond County, New York",4650,3591,1059,0.23,0.77
36085014608,"Census Tract 146.08, Richmond County, New York",3640,2856,784,0.22,0.78
36085014700,"Census Tract 147, Richmond County, New York",3451,2631,820,0.24,0.76
36085015100,"Census Tract 151, Richmond County, New York",5449,3849,1600,0.29,0.71
36085015400,"Census Tract 154, Richmond County, New York",5,3,2,0.4,0.6
36085015601,"Census Tract 156.01, Richmond County, New York",6663,5522,1141,0.17,0.83
36085015602,"Census Tract 156.02, Richmond County, New York",3396,2942,454,0.13,0.87
36085015603,"Census Tract 156.03, Richmond County, New York",4776,3647,1129,0.24,0.76
36085016901,"Census Tract 169.01, Richmond County, New York",3213,1993,1220,0.38,0.62
36085017005,"Census Tract 170.05, Richmond County, New York",4845,3843,1002,0.21,0.79
36085017007,"Census Tract 170.07, Richmond County, New York",5526,3287,2239,0.41,0.59
36085017009,"Census Tract 170.09, Richmond County, New York",4473,3788,685,0.15,0.85
36085017011,"Census Tract 170.11, Richmond County, New York",4587,3612,975,0.21,0.79
36085017012,"Census Tract 170.12, Richmond County, New York",4473,3385,1088,0.24,0.76
36085017013,"Census Tract 170.13, Richmond County, New York",4333,2902,1431,0.33,0.67
36085017014,"Census Tract 170.14, Richmond County, New York",4327,3315,1012,0.23,0.77
36085017015,"Census Tract 170.15, Richmond County, New York",2713,2204,509,0.19,0.81
36085017016,"Census Tract 170.16, Richmond County, New York",4637,3620,1017,0.22,0.78
36085017300,"Census Tract 173, Richmond County, New York",2535,804,1731,0.68,0.32
36085017600,"Census Tract 176, Richmond County, New York",4932,4150,782,0.16,0.84
36085017701,"Census Tract 177.01, Richmond County, New York",4724,3369,1355,0.29,0.71
36085017702,"Census Tract 177.02, Richmond County, New York",2353,1881,472,0.2,0.8
36085018100,"Census Tract 181, Richmond County, New York",3569,2608,961,0.27,0.73
36085018701,"Census Tract 187.01, Richmond County, New York",1836,1074,762,0.42,0.58
36085018703,"Census Tract 187.03, Richmond County, New York",3976,1753,2223,0.56,0.44
36085018704,"Census Tract 187.04, Richmond County, New York",3780,2272,1508,0.4,0.6
36085018901,"Census Tract 189.01, Richmond County, New York",5725,3693,2032,0.35,0.65
36085018902,"Census Tract 189.02, Richmond County, New York",5533,3371,2162,0.39,0.61
36085019700,"Census Tract 197, Richmond County, New York",1958,1463,495,0.25,0.75
36085019800,"Census Tract 198, Richmond County, New York",6627,5484,1143,0.17,0.83
36085020100,"Census Tract 201, Richmond County, New York",3796,2020,1776,0.47,0.53
36085020701,"Census Tract 207.01, Richmond County, New York",3942,269,3673,0.93,0.07
36085020702,"Census Tract 207.02, Richmond County, New York",3436,345,3091,0.9,0.1
36085020803,"Census Tract 208.03, Richmond County, New York",7348,6049,1299,0.18,0.82
36085020804,"Census Tract 208.04, Richmond County, New York",5364,4481,883,0.16,0.84
36085020805,"Census Tract 208.05, Richmond County, New York",6433,5177,1256,0.2,0.8
36085020806,"Census Tract 208.06, Richmond County, New York",2714,2106,608,0.22,0.78
36085021300,"Census Tract 213, Richmond County, New York",5737,1362,4375,0.76,0.24
36085022300,"Census Tract 223, Richmond County, New York",3134,490,2644,0.84,0.16
36085022601,"Census Tract 226.01, Richmond County, New York",6945,5468,1477,0.21,0.79
36085022602,"Census Tract 226.02, Richmond County, New York",1223,945,278,0.23,0.77
36085022801,"Census Tract 228.01, Richmond County, New York",95,31,64,0.67,0.33
36085022802,"Census Tract 228.02, Richmond County, New York",15,4,11,0.73,0.27
36085023100,"Census Tract 231, Richmond County, New York",4959,848,4111,0.83,0.17
36085023900,"Census Tract 239, Richmond County, New York",3605,780,2825,0.78,0.22
36085024401,"Census Tract 244.01, Richmond County, New York",5687,4801,886,0.16,0.84
36085024402,"Census Tract 244.02, Richmond County, New York",4381,3803,578,0.13,0.87
36085024700,"Census Tract 247, Richmond County, New York",2893,810,2083,0.72,0.28
36085024800,"Census Tract 248, Richmond County, New York",4798,3637,1161,0.24,0.76
36085025100,"Census Tract 251, Richmond County, New York",6030,4162,1868,0.31,0.69
36085027301,"Census Tract 273.01, Richmond County, New York",4811,2928,1883,0.39,0.61
36085027302,"Census Tract 273.02, Richmond County, New York",4242,2850,1392,0.33,0.67
36085027702,"Census Tract 277.02, Richmond County, New York",6479,3925,2554,0.39,0.61
36085027704,"Census Tract 277.04, Richmond County, New York",4612,2713,1899,0.41,0.59
36085027705,"Census Tract 277.05, Richmond County, New York",5866,3214,2652,0.45,0.55
36085027706,"Census Tract 277.06, Richmond County, New York",3043,1743,1300,0.43,0.57
36085027900,"Census Tract 279, Richmond County, New York",2110,1689,421,0.2,0.8
36085029102,"Census Tract 291.02, Richmond County, New York",3394,1963,1431,0.42,0.58
36085029104,"Census Tract 291.04, Richmond County, New York",7178,4101,3077,0.43,0.57
36085029105,"Census Tract 291.05, Richmond County, New York",4257,2813,1444,0.34,0.66
36085029106,"Census Tract 291.06, Richmond County, New York",3231,2102,1129,0.35,0.65
36085030301,"Census Tract 303.01, Richmond County, New York",5130,2022,3108,0.61,0.39
36085030302,"Census Tract 303.02, Richmond County, New York",6669,1622,5047,0.76,0.24
36085031901,"Census Tract 319.01, Richmond County, New York",3262,179,3083,0.95,0.05
36085031902,"Census Tract 319.02, Richmond County, New York",5500,472,5028,0.91,0.09
36085032300,"Census Tract 323, Richmond County, New York",1233,205,1028,0.83,0.17
36085990100,"Census Tract 9901, Richmond County, New York",0,0,0,0,0
36087010101,"Census Tract 101.01, Rockland County, New York",5742,3965,1777,0.31,0.69
36087010102,"Census Tract 101.02, Rockland County, New York",4854,3043,1811,0.37,0.63
36087010200,"Census Tract 102, Rockland County, New York",4217,2685,1532,0.36,0.64
36087010501,"Census Tract 105.01, Rockland County, New York",5291,2845,2446,0.46,0.54
36087010503,"Census Tract 105.03, Rockland County, New York",2875,1810,1065,0.37,0.63
36087010504,"Census Tract 105.04, Rockland County, New York",7657,2966,4691,0.61,0.39
36087010601,"Census Tract 106.01, Rockland County, New York",4058,1321,2737,0.67,0.33
36087010602,"Census Tract 106.02, Rockland County, New York",6883,1387,5496,0.8,0.2
36087010701,"Census Tract 107.01, Rockland County, New York",4079,900,3179,0.78,0.22
36087010702,"Census Tract 107.02, Rockland County, New York",4387,312,4075,0.93,0.07
36087010703,"Census Tract 107.03, Rockland County, New York",3857,799,3058,0.79,0.21
36087010801,"Census Tract 108.01, Rockland County, New York",4824,3376,1448,0.3,0.7
36087010802,"Census Tract 108.02, Rockland County, New York",5288,3703,1585,0.3,0.7
36087010803,"Census Tract 108.03, Rockland County, New York",5609,3504,2105,0.38,0.62
36087010804,"Census Tract 108.04, Rockland County, New York",4038,2647,1391,0.34,0.66
36087010901,"Census Tract 109.01, Rockland County, New York",4790,3267,1523,0.32,0.68
36087010902,"Census Tract 109.02, Rockland County, New York",4139,2323,1816,0.44,0.56
36087011000,"Census Tract 110, Rockland County, New York",2015,1571,444,0.22,0.78
36087011101,"Census Tract 111.01, Rockland County, New York",5857,3433,2424,0.41,0.59
36087011102,"Census Tract 111.02, Rockland County, New York",5945,2959,2986,0.5,0.5
36087011200,"Census Tract 112, Rockland County, New York",6545,4557,1988,0.3,0.7
36087011302,"Census Tract 113.02, Rockland County, New York",5614,3110,2504,0.45,0.55
36087011303,"Census Tract 113.03, Rockland County, New York",5667,3345,2322,0.41,0.59
36087011304,"Census Tract 113.04, Rockland County, New York",4651,240,4411,0.95,0.05
36087011305,"Census Tract 113.05, Rockland County, New York",3934,1223,2711,0.69,0.31
36087011401,"Census Tract 114.01, Rockland County, New York",4257,2657,1600,0.38,0.62
36087011403,"Census Tract 114.03, Rockland County, New York",5548,3866,1682,0.3,0.7
36087011404,"Census Tract 114.04, Rockland County, New York",3961,2063,1898,0.48,0.52
36087011405,"Census Tract 114.05, Rockland County, New York",4173,1437,2736,0.66,0.34
36087011505,"Census Tract 115.05, Rockland County, New York",3493,3199,294,0.08,0.92
36087011506,"Census Tract 115.06, Rockland County, New York",6888,6364,524,0.08,0.92
36087011507,"Census Tract 115.07, Rockland County, New York",4384,3616,768,0.18,0.82
36087011508,"Census Tract 115.08, Rockland County, New York",4216,3773,443,0.11,0.89
36087011509,"Census Tract 115.09, Rockland County, New York",3735,2303,1432,0.38,0.62
36087011510,"Census Tract 115.10, Rockland County, New York",4546,2897,1649,0.36,0.64
36087011511,"Census Tract 115.11, Rockland County, New York",3674,547,3127,0.85,0.15
36087011512,"Census Tract 115.12, Rockland County, New York",4202,272,3930,0.94,0.06
36087011601,"Census Tract 116.01, Rockland County, New York",3521,2763,758,0.22,0.78
36087011602,"Census Tract 116.02, Rockland County, New York",6667,5305,1362,0.2,0.8
36087011603,"Census Tract 116.03, Rockland County, New York",6069,4300,1769,0.29,0.71
36087011700,"Census Tract 117, Rockland County, New York",3036,2105,931,0.31,0.69
36087011800,"Census Tract 118, Rockland County, New York",930,354,576,0.62,0.38
36087011901,"Census Tract 119.01, Rockland County, New York",3943,2075,1868,0.47,0.53
36087011902,"Census Tract 119.02, Rockland County, New York",3472,1676,1796,0.52,0.48
36087012000,"Census Tract 120, Rockland County, New York",4026,2847,1179,0.29,0.71
36087012107,"Census Tract 121.07, Rockland County, New York",5463,5067,396,0.07,0.93
36087012108,"Census Tract 121.08, Rockland County, New York",5669,5400,269,0.05,0.95
36087012109,"Census Tract 121.09, Rockland County, New York",3152,2915,237,0.08,0.92
36087012110,"Census Tract 121.10, Rockland County, New York",3741,3494,247,0.07,0.93
36087012111,"Census Tract 121.11, Rockland County, New York",3273,3098,175,0.05,0.95
36087012112,"Census Tract 121.12, Rockland County, New York",4032,3801,231,0.06,0.94
36087012113,"Census Tract 121.13, Rockland County, New York",4489,4227,262,0.06,0.94
36087012114,"Census Tract 121.14, Rockland County, New York",2874,2622,252,0.09,0.91
36087012115,"Census Tract 121.15, Rockland County, New York",1721,635,1086,0.63,0.37
36087012116,"Census Tract 121.16, Rockland County, New York",3242,2930,312,0.1,0.9
36087012203,"Census Tract 122.03, Rockland County, New York",3531,2900,631,0.18,0.82
36087012204,"Census Tract 122.04, Rockland County, New York",3926,3461,465,0.12,0.88
36087012205,"Census Tract 122.05, Rockland County, New York",2669,568,2101,0.79,0.21
36087012206,"Census Tract 122.06, Rockland County, New York",3134,115,3019,0.96,0.04
36087012301,"Census Tract 123.01, Rockland County, New York",3457,1954,1503,0.43,0.57
36087012302,"Census Tract 123.02, Rockland County, New York",3813,551,3262,0.86,0.14
36087012401,"Census Tract 124.01, Rockland County, New York",5307,1217,4090,0.77,0.23
36087012403,"Census Tract 124.03, Rockland County, New York",2498,74,2424,0.97,0.03
36087012404,"Census Tract 124.04, Rockland County, New York",2551,496,2055,0.81,0.19
36087012503,"Census Tract 125.03, Rockland County, New York",2970,2203,767,0.26,0.74
36087012504,"Census Tract 125.04, Rockland County, New York",4119,2818,1301,0.32,0.68
36087012505,"Census Tract 125.05, Rockland County, New York",3243,2820,423,0.13,0.87
36087012506,"Census Tract 125.06, Rockland County, New York",3243,2575,668,0.21,0.79
36087012600,"Census Tract 126, Rockland County, New York",6172,4984,1188,0.19,0.81
36087012700,"Census Tract 127, Rockland County, New York",4363,3402,961,0.22,0.78
36087012800,"Census Tract 128, Rockland County, New York",7238,5942,1296,0.18,0.82
36087013001,"Census Tract 130.01, Rockland County, New York",2439,1707,732,0.3,0.7
36087013002,"Census Tract 130.02, Rockland County, New York",5452,3668,1784,0.33,0.67
36087013003,"Census Tract 130.03, Rockland County, New York",3265,2249,1016,0.31,0.69
36087013101,"Census Tract 131.01, Rockland County, New York",3285,1554,1731,0.53,0.47
36087013102,"Census Tract 131.02, Rockland County, New York",3098,1971,1127,0.36,0.64
36087013200,"Census Tract 132, Rockland County, New York",2699,1602,1097,0.41,0.59
36087013300,"Census Tract 133, Rockland County, New York",2517,1817,700,0.28,0.72
36087013401,"Census Tract 134.01, Rockland County, New York",4395,2979,1416,0.32,0.68
36087013402,"Census Tract 134.02, Rockland County, New York",3732,2587,1145,0.31,0.69
36089490100,"Census Tract 4901, St. Lawrence County, New York",3331,2931,400,0.12,0.88
36089490200,"Census Tract 4902, St. Lawrence County, New York",3633,3225,408,0.11,0.89
36089490300,"Census Tract 4903, St. Lawrence County, New York",5469,4665,804,0.15,0.85
36089490400,"Census Tract 4904, St. Lawrence County, New York",3050,2791,259,0.08,0.92
36089490500,"Census Tract 4905, St. Lawrence County, New York",3979,3713,266,0.07,0.93
36089490600,"Census Tract 4906, St. Lawrence County, New York",4453,4090,363,0.08,0.92
36089490700,"Census Tract 4907, St. Lawrence County, New York",6443,5888,555,0.09,0.91
36089490800,"Census Tract 4908, St. Lawrence County, New York",3393,2896,497,0.15,0.85
36089490900,"Census Tract 4909, St. Lawrence County, New York",3258,2629,629,0.19,0.81
36089491000,"Census Tract 4910, St. Lawrence County, New York",4456,4033,423,0.09,0.91
36089491100,"Census Tract 4911, St. Lawrence County, New York",2248,1408,840,0.37,0.63
36089491200,"Census Tract 4912, St. Lawrence County, New York",1546,994,552,0.36,0.64
36089491300,"Census Tract 4913, St. Lawrence County, New York",4221,3972,249,0.06,0.94
36089491400,"Census Tract 4914, St. Lawrence County, New York",4595,3460,1135,0.25,0.75
36089491500,"Census Tract 4915, St. Lawrence County, New York",3419,3207,212,0.06,0.94
36089491600,"Census Tract 4916, St. Lawrence County, New York",2050,1898,152,0.07,0.93
36089491700,"Census Tract 4917, St. Lawrence County, New York",4158,3991,167,0.04,0.96
36089491800,"Census Tract 4918, St. Lawrence County, New York",4472,4235,237,0.05,0.95
36089491900,"Census Tract 4919, St. Lawrence County, New York",1529,1330,199,0.13,0.87
36089492000,"Census Tract 4920, St. Lawrence County, New York",5618,5059,559,0.1,0.9
36089492100,"Census Tract 4921, St. Lawrence County, New York",4491,3715,776,0.17,0.83
36089492301,"Census Tract 4923.01, St. Lawrence County, New York",3421,3244,177,0.05,0.95
36089492302,"Census Tract 4923.02, St. Lawrence County, New York",2523,2372,151,0.06,0.94
36089492401,"Census Tract 4924.01, St. Lawrence County, New York",2167,2034,133,0.06,0.94
36089492501,"Census Tract 4925.01, St. Lawrence County, New York",2085,1948,137,0.07,0.93
36089492600,"Census Tract 4926, St. Lawrence County, New York",5813,5545,268,0.05,0.95
36089492700,"Census Tract 4927, St. Lawrence County, New York",6551,5471,1080,0.16,0.84
36089492800,"Census Tract 4928, St. Lawrence County, New York",2994,2828,166,0.06,0.94
36089492900,"Census Tract 4929, St. Lawrence County, New York",2057,1952,105,0.05,0.95
36089493000,"Census Tract 4930, St. Lawrence County, New York",1082,1032,50,0.05,0.95
36091060102,"Census Tract 601.02, Saratoga County, New York",6304,5715,589,0.09,0.91
36091060103,"Census Tract 601.03, Saratoga County, New York",1890,1755,135,0.07,0.93
36091060104,"Census Tract 601.04, Saratoga County, New York",4264,3918,346,0.08,0.92
36091060200,"Census Tract 602, Saratoga County, New York",3744,3353,391,0.1,0.9
36091060301,"Census Tract 603.01, Saratoga County, New York",3109,2874,235,0.08,0.92
36091060400,"Census Tract 604, Saratoga County, New York",2562,2355,207,0.08,0.92
36091060501,"Census Tract 605.01, Saratoga County, New York",1976,1808,168,0.09,0.91
36091060504,"Census Tract 605.04, Saratoga County, New York",1154,1093,61,0.05,0.95
36091060505,"Census Tract 605.05, Saratoga County, New York",998,929,69,0.07,0.93
36091060506,"Census Tract 605.06, Saratoga County, New York",1675,1555,120,0.07,0.93
36091060507,"Census Tract 605.07, Saratoga County, New York",400,365,35,0.09,0.91
36091060601,"Census Tract 606.01, Saratoga County, New York",3083,2744,339,0.11,0.89
36091060602,"Census Tract 606.02, Saratoga County, New York",4921,4442,479,0.1,0.9
36091060703,"Census Tract 607.03, Saratoga County, New York",3119,2773,346,0.11,0.89
36091060704,"Census Tract 607.04, Saratoga County, New York",4786,4233,553,0.12,0.88
36091060705,"Census Tract 607.05, Saratoga County, New York",3919,3359,560,0.14,0.86
36091060706,"Census Tract 607.06, Saratoga County, New York",5537,4916,621,0.11,0.89
36091060800,"Census Tract 608, Saratoga County, New York",5242,4632,610,0.12,0.88
36091060901,"Census Tract 609.01, Saratoga County, New York",3961,3644,317,0.08,0.92
36091060902,"Census Tract 609.02, Saratoga County, New York",1847,1696,151,0.08,0.92
36091061001,"Census Tract 610.01, Saratoga County, New York",2432,2195,237,0.1,0.9
36091061002,"Census Tract 610.02, Saratoga County, New York",1789,1468,321,0.18,0.82
36091061101,"Census Tract 611.01, Saratoga County, New York",2002,1543,459,0.23,0.77
36091061102,"Census Tract 611.02, Saratoga County, New York",3701,3359,342,0.09,0.91
36091061201,"Census Tract 612.01, Saratoga County, New York",2232,2006,226,0.1,0.9
36091061202,"Census Tract 612.02, Saratoga County, New York",3272,2820,452,0.14,0.86
36091061301,"Census Tract 613.01, Saratoga County, New York",3956,3568,388,0.1,0.9
36091061303,"Census Tract 613.03, Saratoga County, New York",2123,1368,755,0.36,0.64
36091061304,"Census Tract 613.04, Saratoga County, New York",2831,2445,386,0.14,0.86
36091061305,"Census Tract 613.05, Saratoga County, New York",4153,3502,651,0.16,0.84
36091061401,"Census Tract 614.01, Saratoga County, New York",4920,4344,576,0.12,0.88
36091061403,"Census Tract 614.03, Saratoga County, New York",6460,5719,741,0.11,0.89
36091061404,"Census Tract 614.04, Saratoga County, New York",3081,2759,322,0.1,0.9
36091061500,"Census Tract 615, Saratoga County, New York",3525,3248,277,0.08,0.92
36091061600,"Census Tract 616, Saratoga County, New York",4328,4005,323,0.07,0.93
36091061701,"Census Tract 617.01, Saratoga County, New York",6583,5588,995,0.15,0.85
36091061702,"Census Tract 617.02, Saratoga County, New York",4228,3856,372,0.09,0.91
36091061800,"Census Tract 618, Saratoga County, New York",5359,4644,715,0.13,0.87
36091061904,"Census Tract 619.04, Saratoga County, New York",6092,5339,753,0.12,0.88
36091061905,"Census Tract 619.05, Saratoga County, New York",3584,3133,451,0.13,0.87
36091061906,"Census Tract 619.06, Saratoga County, New York",3271,2660,611,0.19,0.81
36091061907,"Census Tract 619.07, Saratoga County, New York",4183,3528,655,0.16,0.84
36091062001,"Census Tract 620.01, Saratoga County, New York",4700,4247,453,0.1,0.9
36091062002,"Census Tract 620.02, Saratoga County, New York",2568,2400,168,0.07,0.93
36091062100,"Census Tract 621, Saratoga County, New York",1754,1548,206,0.12,0.88
36091062200,"Census Tract 622, Saratoga County, New York",3117,2712,405,0.13,0.87
36091062300,"Census Tract 623, Saratoga County, New York",2046,1828,218,0.11,0.89
36091062404,"Census Tract 624.04, Saratoga County, New York",3003,2698,305,0.1,0.9
36091062406,"Census Tract 624.06, Saratoga County, New York",3928,3174,754,0.19,0.81
36091062407,"Census Tract 624.07, Saratoga County, New York",4448,3616,832,0.19,0.81
36091062408,"Census Tract 624.08, Saratoga County, New York",2772,2370,402,0.15,0.85
36091062409,"Census Tract 624.09, Saratoga County, New York",3042,2468,574,0.19,0.81
36091062410,"Census Tract 624.10, Saratoga County, New York",3978,2730,1248,0.31,0.69
36091062501,"Census Tract 625.01, Saratoga County, New York",5138,4463,675,0.13,0.87
36091062503,"Census Tract 625.03, Saratoga County, New York",5806,4710,1096,0.19,0.81
36091062505,"Census Tract 625.05, Saratoga County, New York",4491,3790,701,0.16,0.84
36091062506,"Census Tract 625.06, Saratoga County, New York",5729,4522,1207,0.21,0.79
36091062507,"Census Tract 625.07, Saratoga County, New York",3830,2955,875,0.23,0.77
36091062508,"Census Tract 625.08, Saratoga County, New York",4474,3587,887,0.2,0.8
36091062509,"Census Tract 625.09, Saratoga County, New York",3328,2768,560,0.17,0.83
36091062601,"Census Tract 626.01, Saratoga County, New York",2691,2408,283,0.11,0.89
36091062602,"Census Tract 626.02, Saratoga County, New York",7033,5604,1429,0.2,0.8
36091062700,"Census Tract 627, Saratoga County, New York",6170,5418,752,0.12,0.88
36091062800,"Census Tract 628, Saratoga County, New York",2038,1739,299,0.15,0.85
36091062900,"Census Tract 629, Saratoga County, New York",829,770,59,0.07,0.93
36093020101,"Census Tract 201.01, Schenectady County, New York",2342,1428,914,0.39,0.61
36093020102,"Census Tract 201.02, Schenectady County, New York",2605,983,1622,0.62,0.38
36093020200,"Census Tract 202, Schenectady County, New York",2839,1203,1636,0.58,0.42
36093020300,"Census Tract 203, Schenectady County, New York",1771,977,794,0.45,0.55
36093020500,"Census Tract 205, Schenectady County, New York",4693,2890,1803,0.38,0.62
36093020600,"Census Tract 206, Schenectady County, New York",3179,1607,1572,0.49,0.51
36093020700,"Census Tract 207, Schenectady County, New York",5618,1380,4238,0.75,0.25
36093020800,"Census Tract 208, Schenectady County, New York",3943,1173,2770,0.7,0.3
36093020900,"Census Tract 209, Schenectady County, New York",3767,507,3260,0.87,0.13
36093021001,"Census Tract 210.01, Schenectady County, New York",926,398,528,0.57,0.43
36093021002,"Census Tract 210.02, Schenectady County, New York",2311,548,1763,0.76,0.24
36093021200,"Census Tract 212, Schenectady County, New York",2892,1690,1202,0.42,0.58
36093021400,"Census Tract 214, Schenectady County, New York",3526,1011,2515,0.71,0.29
36093021500,"Census Tract 215, Schenectady County, New York",3227,790,2437,0.76,0.24
36093021600,"Census Tract 216, Schenectady County, New York",3709,1346,2363,0.64,0.36
36093021700,"Census Tract 217, Schenectady County, New York",4167,1033,3134,0.75,0.25
36093021801,"Census Tract 218.01, Schenectady County, New York",2099,1381,718,0.34,0.66
36093021802,"Census Tract 218.02, Schenectady County, New York",4649,3173,1476,0.32,0.68
36093031901,"Census Tract 319.01, Schenectady County, New York",4646,3504,1142,0.25,0.75
36093031902,"Census Tract 319.02, Schenectady County, New York",3315,2603,712,0.21,0.79
36093032000,"Census Tract 320, Schenectady County, New York",7108,5007,2101,0.3,0.7
36093032101,"Census Tract 321.01, Schenectady County, New York",6027,4431,1596,0.26,0.74
36093032102,"Census Tract 321.02, Schenectady County, New York",1827,1414,413,0.23,0.77
36093032200,"Census Tract 322, Schenectady County, New York",4657,3906,751,0.16,0.84
36093032300,"Census Tract 323, Schenectady County, New York",2615,2251,364,0.14,0.86
36093032402,"Census Tract 324.02, Schenectady County, New York",3482,2907,575,0.17,0.83
36093032403,"Census Tract 324.03, Schenectady County, New York",2174,1906,268,0.12,0.88
36093032404,"Census Tract 324.04, Schenectady County, New York",6675,5918,757,0.11,0.89
36093032502,"Census Tract 325.02, Schenectady County, New York",3494,3139,355,0.1,0.9
36093032503,"Census Tract 325.03, Schenectady County, New York",4023,3562,461,0.11,0.89
36093032504,"Census Tract 325.04, Schenectady County, New York",2206,2014,192,0.09,0.91
36093032601,"Census Tract 326.01, Schenectady County, New York",2285,2004,281,0.12,0.88
36093032602,"Census Tract 326.02, Schenectady County, New York",4328,3734,594,0.14,0.86
36093032700,"Census Tract 327, Schenectady County, New York",4019,3301,718,0.18,0.82
36093032901,"Census Tract 329.01, Schenectady County, New York",3808,3148,660,0.17,0.83
36093032902,"Census Tract 329.02, Schenectady County, New York",4391,3596,795,0.18,0.82
36093033002,"Census Tract 330.02, Schenectady County, New York",2541,2244,297,0.12,0.88
36093033003,"Census Tract 330.03, Schenectady County, New York",3869,3362,507,0.13,0.87
36093033004,"Census Tract 330.04, Schenectady County, New York",2987,2458,529,0.18,0.82
36093033101,"Census Tract 331.01, Schenectady County, New York",2024,1864,160,0.08,0.92
36093033102,"Census Tract 331.02, Schenectady County, New York",5863,5360,503,0.09,0.91
36093033200,"Census Tract 332, Schenectady County, New York",3405,1949,1456,0.43,0.57
36093033300,"Census Tract 333, Schenectady County, New York",2295,1850,445,0.19,0.81
36093033400,"Census Tract 334, Schenectady County, New York",3219,2079,1140,0.35,0.65
36093033500,"Census Tract 335, Schenectady County, New York",2515,1849,666,0.26,0.74
36095740100,"Census Tract 7401, Schoharie County, New York",4913,4422,491,0.1,0.9
36095740200,"Census Tract 7402, Schoharie County, New York",4996,4439,557,0.11,0.89
36095740300,"Census Tract 7403, Schoharie County, New York",1090,801,289,0.27,0.73
36095740400,"Census Tract 7404, Schoharie County, New York",5048,4617,431,0.09,0.91
36095740500,"Census Tract 7405, Schoharie County, New York",3538,3155,383,0.11,0.89
36095740600,"Census Tract 7406, Schoharie County, New York",2840,2561,279,0.1,0.9
36095740700,"Census Tract 7407, Schoharie County, New York",4628,4254,374,0.08,0.92
36095740800,"Census Tract 7408, Schoharie County, New York",2661,2409,252,0.09,0.91
36097950100,"Census Tract 9501, Schuyler County, New York",4895,4556,339,0.07,0.93
36097950200,"Census Tract 9502, Schuyler County, New York",1719,1586,133,0.08,0.92
36097950300,"Census Tract 9503, Schuyler County, New York",3045,2885,160,0.05,0.95
36097950400,"Census Tract 9504, Schuyler County, New York",3752,3455,297,0.08,0.92
36097950500,"Census Tract 9505, Schuyler County, New York",4487,4136,351,0.08,0.92
36099950100,"Census Tract 9501, Seneca County, New York",2401,2215,186,0.08,0.92
36099950200,"Census Tract 9502, Seneca County, New York",2668,2345,323,0.12,0.88
36099950300,"Census Tract 9503, Seneca County, New York",3465,3008,457,0.13,0.87
36099950400,"Census Tract 9504, Seneca County, New York",2894,2521,373,0.13,0.87
36099950500,"Census Tract 9505, Seneca County, New York",3683,3205,478,0.13,0.87
36099950600,"Census Tract 9506, Seneca County, New York",3695,3210,485,0.13,0.87
36099950700,"Census Tract 9507, Seneca County, New York",3657,3359,298,0.08,0.92
36099950801,"Census Tract 9508.01, Seneca County, New York",991,218,773,0.78,0.22
36099950802,"Census Tract 9508.02, Seneca County, New York",3868,3480,388,0.1,0.9
36099950900,"Census Tract 9509, Seneca County, New York",4329,3733,596,0.14,0.86
36099951000,"Census Tract 9510, Seneca County, New York",2163,1979,184,0.09,0.91
36101960100,"Census Tract 9601, Steuben County, New York",1258,1187,71,0.06,0.94
36101960200,"Census Tract 9602, Steuben County, New York",3119,2851,268,0.09,0.91
36101960300,"Census Tract 9603, Steuben County, New York",2269,2129,140,0.06,0.94
36101960400,"Census Tract 9604, Steuben County, New York",3732,3447,285,0.08,0.92
36101960500,"Census Tract 9605, Steuben County, New York",2729,2533,196,0.07,0.93
36101960600,"Census Tract 9606, Steuben County, New York",4039,3717,322,0.08,0.92
36101960700,"Census Tract 9607, Steuben County, New York",2858,2473,385,0.13,0.87
36101960800,"Census Tract 9608, Steuben County, New York",2893,2494,399,0.14,0.86
36101960900,"Census Tract 9609, Steuben County, New York",2507,2102,405,0.16,0.84
36101961000,"Census Tract 9610, Steuben County, New York",3379,3132,247,0.07,0.93
36101961100,"Census Tract 9611, Steuben County, New York",4174,3794,380,0.09,0.91
36101961200,"Census Tract 9612, Steuben County, New York",3579,3254,325,0.09,0.91
36101961300,"Census Tract 9613, Steuben County, New York",3671,3433,238,0.06,0.94
36101961400,"Census Tract 9614, Steuben County, New York",2122,1978,144,0.07,0.93
36101961500,"Census Tract 9615, Steuben County, New York",1815,1697,118,0.07,0.93
36101961600,"Census Tract 9616, Steuben County, New York",1684,1520,164,0.1,0.9
36101961700,"Census Tract 9617, Steuben County, New York",3160,2985,175,0.06,0.94
36101961800,"Census Tract 9618, Steuben County, New York",3245,3064,181,0.06,0.94
36101961900,"Census Tract 9619, Steuben County, New York",3295,3055,240,0.07,0.93
36101962000,"Census Tract 9620, Steuben County, New York",4113,3955,158,0.04,0.96
36101962100,"Census Tract 9621, Steuben County, New York",3055,2936,119,0.04,0.96
36101962200,"Census Tract 9622, Steuben County, New York",2397,2225,172,0.07,0.93
36101962301,"Census Tract 9623.01, Steuben County, New York",5257,3921,1336,0.25,0.75
36101962302,"Census Tract 9623.02, Steuben County, New York",2838,2563,275,0.1,0.9
36101962400,"Census Tract 9624, Steuben County, New York",2776,2373,403,0.15,0.85
36101962500,"Census Tract 9625, Steuben County, New York",2307,2003,304,0.13,0.87
36101962600,"Census Tract 9626, Steuben County, New York",2262,1941,321,0.14,0.86
36101962700,"Census Tract 9627, Steuben County, New York",3206,2700,506,0.16,0.84
36101962800,"Census Tract 9628, Steuben County, New York",3144,2807,337,0.11,0.89
36101962900,"Census Tract 9629, Steuben County, New York",2839,2472,367,0.13,0.87
36101963000,"Census Tract 9630, Steuben County, New York",3862,3597,265,0.07,0.93
36103110101,"Census Tract 1101.01, Suffolk County, New York",3571,3100,471,0.13,0.87
36103110103,"Census Tract 1101.03, Suffolk County, New York",1997,1726,271,0.14,0.86
36103110104,"Census Tract 1101.04, Suffolk County, New York",3057,2617,440,0.14,0.86
36103110200,"Census Tract 1102, Suffolk County, New York",5019,4385,634,0.13,0.87
36103110300,"Census Tract 1103, Suffolk County, New York",4677,4066,611,0.13,0.87
36103110401,"Census Tract 1104.01, Suffolk County, New York",2273,2067,206,0.09,0.91
36103110402,"Census Tract 1104.02, Suffolk County, New York",3471,3082,389,0.11,0.89
36103110501,"Census Tract 1105.01, Suffolk County, New York",3169,2825,344,0.11,0.89
36103110502,"Census Tract 1105.02, Suffolk County, New York",2960,2342,618,0.21,0.79
36103110601,"Census Tract 1106.01, Suffolk County, New York",4515,4098,417,0.09,0.91
36103110602,"Census Tract 1106.02, Suffolk County, New York",2832,2465,367,0.13,0.87
36103110801,"Census Tract 1108.01, Suffolk County, New York",1940,1753,187,0.1,0.9
36103110803,"Census Tract 1108.03, Suffolk County, New York",5867,5171,696,0.12,0.88
36103110901,"Census Tract 1109.01, Suffolk County, New York",2821,2263,558,0.2,0.8
36103110902,"Census Tract 1109.02, Suffolk County, New York",4299,1445,2854,0.66,0.34
36103111001,"Census Tract 1110.01, Suffolk County, New York",2237,1631,606,0.27,0.73
36103111002,"Census Tract 1110.02, Suffolk County, New York",5902,1873,4029,0.68,0.32
36103111101,"Census Tract 1111.01, Suffolk County, New York",2405,872,1533,0.64,0.36
36103111102,"Census Tract 1111.02, Suffolk County, New York",2574,401,2173,0.84,0.16
36103111103,"Census Tract 1111.03, Suffolk County, New York",4247,581,3666,0.86,0.14
36103111201,"Census Tract 1112.01, Suffolk County, New York",4026,1119,2907,0.72,0.28
36103111202,"Census Tract 1112.02, Suffolk County, New York",4879,2492,2387,0.49,0.51
36103111300,"Census Tract 1113, Suffolk County, New York",4716,4041,675,0.14,0.86
36103111401,"Census Tract 1114.01, Suffolk County, New York",1377,977,400,0.29,0.71
36103111402,"Census Tract 1114.02, Suffolk County, New York",5054,3535,1519,0.3,0.7
36103111503,"Census Tract 1115.03, Suffolk County, New York",4002,2722,1280,0.32,0.68
36103111504,"Census Tract 1115.04, Suffolk County, New York",2025,1678,347,0.17,0.83
36103111506,"Census Tract 1115.06, Suffolk County, New York",3185,1773,1412,0.44,0.56
36103111507,"Census Tract 1115.07, Suffolk County, New York",2321,450,1871,0.81,0.19
36103111508,"Census Tract 1115.08, Suffolk County, New York",4434,2724,1710,0.39,0.61
36103111601,"Census Tract 1116.01, Suffolk County, New York",3927,3201,726,0.18,0.82
36103111602,"Census Tract 1116.02, Suffolk County, New York",3154,2655,499,0.16,0.84
36103111701,"Census Tract 1117.01, Suffolk County, New York",5693,4543,1150,0.2,0.8
36103111703,"Census Tract 1117.03, Suffolk County, New York",3182,2596,586,0.18,0.82
36103111704,"Census Tract 1117.04, Suffolk County, New York",3274,2818,456,0.14,0.86
36103111801,"Census Tract 1118.01, Suffolk County, New York",6160,4830,1330,0.22,0.78
36103111802,"Census Tract 1118.02, Suffolk County, New York",2860,2405,455,0.16,0.84
36103111803,"Census Tract 1118.03, Suffolk County, New York",2723,2165,558,0.2,0.8
36103111804,"Census Tract 1118.04, Suffolk County, New York",2328,1900,428,0.18,0.82
36103111900,"Census Tract 1119, Suffolk County, New York",5385,4231,1154,0.21,0.79
36103112001,"Census Tract 1120.01, Suffolk County, New York",4603,3065,1538,0.33,0.67
36103112002,"Census Tract 1120.02, Suffolk County, New York",4958,3799,1159,0.23,0.77
36103112102,"Census Tract 1121.02, Suffolk County, New York",3900,2833,1067,0.27,0.73
36103112103,"Census Tract 1121.03, Suffolk County, New York",4564,3715,849,0.19,0.81
36103112104,"Census Tract 1121.04, Suffolk County, New York",2251,1353,898,0.4,0.6
36103112204,"Census Tract 1122.04, Suffolk County, New York",3287,2612,675,0.21,0.79
36103112211,"Census Tract 1122.11, Suffolk County, New York",4449,3306,1143,0.26,0.74
36103112212,"Census Tract 1122.12, Suffolk County, New York",3312,2112,1200,0.36,0.64
36103112213,"Census Tract 1122.13, Suffolk County, New York",5566,3136,2430,0.44,0.56
36103112215,"Census Tract 1122.15, Suffolk County, New York",3771,2707,1064,0.28,0.72
36103112216,"Census Tract 1122.16, Suffolk County, New York",4386,2774,1612,0.37,0.63
36103112217,"Census Tract 1122.17, Suffolk County, New York",2316,1585,731,0.32,0.68
36103112218,"Census Tract 1122.18, Suffolk County, New York",5489,4159,1330,0.24,0.76
36103112219,"Census Tract 1122.19, Suffolk County, New York",3482,2713,769,0.22,0.78
36103112220,"Census Tract 1122.20, Suffolk County, New York",3255,2463,792,0.24,0.76
36103122300,"Census Tract 1223, Suffolk County, New York",4311,2702,1609,0.37,0.63
36103122405,"Census Tract 1224.05, Suffolk County, New York",3507,527,2980,0.85,0.15
36103122406,"Census Tract 1224.06, Suffolk County, New York",7088,144,6944,0.98,0.02
36103122407,"Census Tract 1224.07, Suffolk County, New York",1633,392,1241,0.76,0.24
36103122408,"Census Tract 1224.08, Suffolk County, New York",3642,2332,1310,0.36,0.64
36103122501,"Census Tract 1225.01, Suffolk County, New York",4788,231,4557,0.95,0.05
36103122502,"Census Tract 1225.02, Suffolk County, New York",4877,159,4718,0.97,0.03
36103122602,"Census Tract 1226.02, Suffolk County, New York",4759,2727,2032,0.43,0.57
36103122603,"Census Tract 1226.03, Suffolk County, New York",5485,3358,2127,0.39,0.61
36103122604,"Census Tract 1226.04, Suffolk County, New York",4076,2179,1897,0.47,0.53
36103122605,"Census Tract 1226.05, Suffolk County, New York",1903,988,915,0.48,0.52
36103122704,"Census Tract 1227.04, Suffolk County, New York",2659,989,1670,0.63,0.37
36103122705,"Census Tract 1227.05, Suffolk County, New York",3226,1803,1423,0.44,0.56
36103122706,"Census Tract 1227.06, Suffolk County, New York",4285,2576,1709,0.4,0.6
36103122707,"Census Tract 1227.07, Suffolk County, New York",3113,1915,1198,0.38,0.62
36103122801,"Census Tract 1228.01, Suffolk County, New York",5894,2082,3812,0.65,0.35
36103122802,"Census Tract 1228.02, Suffolk County, New York",4847,2551,2296,0.47,0.53
36103122901,"Census Tract 1229.01, Suffolk County, New York",5905,4164,1741,0.29,0.71
36103122902,"Census Tract 1229.02, Suffolk County, New York",4562,3186,1376,0.3,0.7
36103123001,"Census Tract 1230.01, Suffolk County, New York",5894,3673,2221,0.38,0.62
36103123002,"Census Tract 1230.02, Suffolk County, New York",4900,2897,2003,0.41,0.59
36103123101,"Census Tract 1231.01, Suffolk County, New York",3659,2467,1192,0.33,0.67
36103123102,"Census Tract 1231.02, Suffolk County, New York",3972,2795,1177,0.3,0.7
36103123201,"Census Tract 1232.01, Suffolk County, New York",2306,682,1624,0.7,0.3
36103123203,"Census Tract 1232.03, Suffolk County, New York",3253,107,3146,0.97,0.03
36103123204,"Census Tract 1232.04, Suffolk County, New York",5845,552,5293,0.91,0.09
36103123303,"Census Tract 1233.03, Suffolk County, New York",4284,194,4090,0.95,0.05
36103123304,"Census Tract 1233.04, Suffolk County, New York",5558,834,4724,0.85,0.15
36103123401,"Census Tract 1234.01, Suffolk County, New York",4138,2360,1778,0.43,0.57
36103123403,"Census Tract 1234.03, Suffolk County, New York",1956,894,1062,0.54,0.46
36103123404,"Census Tract 1234.04, Suffolk County, New York",5609,3777,1832,0.33,0.67
36103123500,"Census Tract 1235, Suffolk County, New York",5945,3227,2718,0.46,0.54
36103123600,"Census Tract 1236, Suffolk County, New York",3652,3206,446,0.12,0.88
36103123701,"Census Tract 1237.01, Suffolk County, New York",7050,1286,5764,0.82,0.18
36103123703,"Census Tract 1237.03, Suffolk County, New York",4147,1695,2452,0.59,0.41
36103123704,"Census Tract 1237.04, Suffolk County, New York",4632,2071,2561,0.55,0.45
36103123801,"Census Tract 1238.01, Suffolk County, New York",4058,3170,888,0.22,0.78
36103123802,"Census Tract 1238.02, Suffolk County, New York",3542,2521,1021,0.29,0.71
36103123900,"Census Tract 1239, Suffolk County, New York",5129,3642,1487,0.29,0.71
36103124001,"Census Tract 1240.01, Suffolk County, New York",4588,3511,1077,0.23,0.77
36103124002,"Census Tract 1240.02, Suffolk County, New York",3374,2500,874,0.26,0.74
36103124101,"Census Tract 1241.01, Suffolk County, New York",4557,3390,1167,0.26,0.74
36103124102,"Census Tract 1241.02, Suffolk County, New York",3416,2725,691,0.2,0.8
36103124200,"Census Tract 1242, Suffolk County, New York",6084,4780,1304,0.21,0.79
36103124301,"Census Tract 1243.01, Suffolk County, New York",2139,1404,735,0.34,0.66
36103124302,"Census Tract 1243.02, Suffolk County, New York",4422,3241,1181,0.27,0.73
36103124401,"Census Tract 1244.01, Suffolk County, New York",3929,3286,643,0.16,0.84
36103124402,"Census Tract 1244.02, Suffolk County, New York",3437,2818,619,0.18,0.82
36103124500,"Census Tract 1245, Suffolk County, New York",4996,4067,929,0.19,0.81
36103124601,"Census Tract 1246.01, Suffolk County, New York",2763,2391,372,0.13,0.87
36103124602,"Census Tract 1246.02, Suffolk County, New York",4429,3763,666,0.15,0.85
36103134702,"Census Tract 1347.02, Suffolk County, New York",6321,5143,1178,0.19,0.81
36103134703,"Census Tract 1347.03, Suffolk County, New York",3785,3279,506,0.13,0.87
36103134704,"Census Tract 1347.04, Suffolk County, New York",2891,2489,402,0.14,0.86
36103134902,"Census Tract 1349.02, Suffolk County, New York",5013,3973,1040,0.21,0.79
36103134906,"Census Tract 1349.06, Suffolk County, New York",5379,4755,624,0.12,0.88
36103134907,"Census Tract 1349.07, Suffolk County, New York",3791,3231,560,0.15,0.85
36103134908,"Census Tract 1349.08, Suffolk County, New York",3356,2737,619,0.18,0.82
36103134909,"Census Tract 1349.09, Suffolk County, New York",4337,3661,676,0.16,0.84
36103135002,"Census Tract 1350.02, Suffolk County, New York",5322,4458,864,0.16,0.84
36103135003,"Census Tract 1350.03, Suffolk County, New York",4734,4030,704,0.15,0.85
36103135004,"Census Tract 1350.04, Suffolk County, New York",3084,2604,480,0.16,0.84
36103135005,"Census Tract 1350.05, Suffolk County, New York",3431,3012,419,0.12,0.88
36103135101,"Census Tract 1351.01, Suffolk County, New York",3965,3090,875,0.22,0.78
36103135102,"Census Tract 1351.02, Suffolk County, New York",4359,3616,743,0.17,0.83
36103135103,"Census Tract 1351.03, Suffolk County, New York",4835,4057,778,0.16,0.84
36103135104,"Census Tract 1351.04, Suffolk County, New York",5081,4262,819,0.16,0.84
36103135201,"Census Tract 1352.01, Suffolk County, New York",2071,1718,353,0.17,0.83
36103135205,"Census Tract 1352.05, Suffolk County, New York",5376,4006,1370,0.25,0.75
36103135208,"Census Tract 1352.08, Suffolk County, New York",2848,2273,575,0.2,0.8
36103135209,"Census Tract 1352.09, Suffolk County, New York",3151,2506,645,0.2,0.8
36103135303,"Census Tract 1353.03, Suffolk County, New York",4296,3337,959,0.22,0.78
36103135305,"Census Tract 1353.05, Suffolk County, New York",1741,1537,204,0.12,0.88
36103135306,"Census Tract 1353.06, Suffolk County, New York",4896,4062,834,0.17,0.83
36103135401,"Census Tract 1354.01, Suffolk County, New York",6422,5063,1359,0.21,0.79
36103135402,"Census Tract 1354.02, Suffolk County, New York",6785,5512,1273,0.19,0.81
36103135403,"Census Tract 1354.03, Suffolk County, New York",4314,3275,1039,0.24,0.76
36103135500,"Census Tract 1355, Suffolk County, New York",4712,4016,696,0.15,0.85
36103145601,"Census Tract 1456.01, Suffolk County, New York",6003,762,5241,0.87,0.13
36103145602,"Census Tract 1456.02, Suffolk County, New York",6592,609,5983,0.91,0.09
36103145603,"Census Tract 1456.03, Suffolk County, New York",7011,326,6685,0.95,0.05
36103145604,"Census Tract 1456.04, Suffolk County, New York",5079,346,4733,0.93,0.07
36103145605,"Census Tract 1456.05, Suffolk County, New York",3869,428,3441,0.89,0.11
36103145701,"Census Tract 1457.01, Suffolk County, New York",5432,3477,1955,0.36,0.64
36103145702,"Census Tract 1457.02, Suffolk County, New York",6640,675,5965,0.9,0.1
36103145703,"Census Tract 1457.03, Suffolk County, New York",6011,601,5410,0.9,0.1
36103145705,"Census Tract 1457.05, Suffolk County, New York",2395,531,1864,0.78,0.22
36103145706,"Census Tract 1457.06, Suffolk County, New York",5359,661,4698,0.88,0.12
36103145803,"Census Tract 1458.03, Suffolk County, New York",4742,3763,979,0.21,0.79
36103145804,"Census Tract 1458.04, Suffolk County, New York",3567,1651,1916,0.54,0.46
36103145807,"Census Tract 1458.07, Suffolk County, New York",4239,3139,1100,0.26,0.74
36103145808,"Census Tract 1458.08, Suffolk County, New York",3065,2292,773,0.25,0.75
36103145809,"Census Tract 1458.09, Suffolk County, New York",2062,1385,677,0.33,0.67
36103145810,"Census Tract 1458.10, Suffolk County, New York",3970,2922,1048,0.26,0.74
36103145901,"Census Tract 1459.01, Suffolk County, New York",3458,1024,2434,0.7,0.3
36103145903,"Census Tract 1459.03, Suffolk County, New York",5894,2882,3012,0.51,0.49
36103145904,"Census Tract 1459.04, Suffolk County, New York",4579,346,4233,0.92,0.08
36103145905,"Census Tract 1459.05, Suffolk County, New York",4543,648,3895,0.86,0.14
36103146001,"Census Tract 1460.01, Suffolk County, New York",5096,391,4705,0.92,0.08
36103146002,"Census Tract 1460.02, Suffolk County, New York",5499,511,4988,0.91,0.09
36103146004,"Census Tract 1460.04, Suffolk County, New York",1941,354,1587,0.82,0.18
36103146005,"Census Tract 1460.05, Suffolk County, New York",6603,1406,5197,0.79,0.21
36103146102,"Census Tract 1461.02, Suffolk County, New York",2756,379,2377,0.86,0.14
36103146103,"Census Tract 1461.03, Suffolk County, New York",4032,2388,1644,0.41,0.59
36103146105,"Census Tract 1461.05, Suffolk County, New York",7294,590,6704,0.92,0.08
36103146106,"Census Tract 1461.06, Suffolk County, New York",4761,598,4163,0.87,0.13
36103146201,"Census Tract 1462.01, Suffolk County, New York",5137,523,4614,0.9,0.1
36103146202,"Census Tract 1462.02, Suffolk County, New York",5047,266,4781,0.95,0.05
36103146203,"Census Tract 1462.03, Suffolk County, New York",6027,638,5389,0.89,0.11
36103146204,"Census Tract 1462.04, Suffolk County, New York",6587,568,6019,0.91,0.09
36103146205,"Census Tract 1462.05, Suffolk County, New York",2311,1660,651,0.28,0.72
36103146206,"Census Tract 1462.06, Suffolk County, New York",2443,1264,1179,0.48,0.52
36103146300,"Census Tract 1463, Suffolk County, New York",2607,1360,1247,0.48,0.52
36103146402,"Census Tract 1464.02, Suffolk County, New York",4392,3278,1114,0.25,0.75
36103146403,"Census Tract 1464.03, Suffolk County, New York",5845,494,5351,0.92,0.08
36103146404,"Census Tract 1464.04, Suffolk County, New York",3297,782,2515,0.76,0.24
36103146500,"Census Tract 1465, Suffolk County, New York",5323,4023,1300,0.24,0.76
36103146607,"Census Tract 1466.07, Suffolk County, New York",2546,1890,656,0.26,0.74
36103146608,"Census Tract 1466.08, Suffolk County, New York",2629,2015,614,0.23,0.77
36103146611,"Census Tract 1466.11, Suffolk County, New York",3109,2438,671,0.22,0.78
36103146612,"Census Tract 1466.12, Suffolk County, New York",4908,3921,987,0.2,0.8
36103146613,"Census Tract 1466.13, Suffolk County, New York",3568,2835,733,0.21,0.79
36103146614,"Census Tract 1466.14, Suffolk County, New York",5556,4592,964,0.17,0.83
36103146616,"Census Tract 1466.16, Suffolk County, New York",3870,3268,602,0.16,0.84
36103146617,"Census Tract 1466.17, Suffolk County, New York",3436,2916,520,0.15,0.85
36103146618,"Census Tract 1466.18, Suffolk County, New York",5619,3903,1716,0.31,0.69
36103146619,"Census Tract 1466.19, Suffolk County, New York",3072,2247,825,0.27,0.73
36103146620,"Census Tract 1466.20, Suffolk County, New York",1888,1555,333,0.18,0.82
36103146703,"Census Tract 1467.03, Suffolk County, New York",4268,1537,2731,0.64,0.36
36103146704,"Census Tract 1467.04, Suffolk County, New York",2024,1655,369,0.18,0.82
36103146705,"Census Tract 1467.05, Suffolk County, New York",3252,2811,441,0.14,0.86
36103146706,"Census Tract 1467.06, Suffolk County, New York",2582,2036,546,0.21,0.79
36103146800,"Census Tract 1468, Suffolk County, New York",5783,4981,802,0.14,0.86
36103146901,"Census Tract 1469.01, Suffolk County, New York",5273,4698,575,0.11,0.89
36103146902,"Census Tract 1469.02, Suffolk County, New York",4345,3486,859,0.2,0.8
36103147001,"Census Tract 1470.01, Suffolk County, New York",4295,3737,558,0.13,0.87
36103147003,"Census Tract 1470.03, Suffolk County, New York",4625,3680,945,0.2,0.8
36103147004,"Census Tract 1470.04, Suffolk County, New York",693,585,108,0.16,0.84
36103147100,"Census Tract 1471, Suffolk County, New York",3181,2718,463,0.15,0.85
36103147201,"Census Tract 1472.01, Suffolk County, New York",3714,2122,1592,0.43,0.57
36103147202,"Census Tract 1472.02, Suffolk County, New York",2905,756,2149,0.74,0.26
36103147301,"Census Tract 1473.01, Suffolk County, New York",2909,532,2377,0.82,0.18
36103147302,"Census Tract 1473.02, Suffolk County, New York",4772,2282,2490,0.52,0.48
36103147401,"Census Tract 1474.01, Suffolk County, New York",5969,4131,1838,0.31,0.69
36103147402,"Census Tract 1474.02, Suffolk County, New York",3663,3260,403,0.11,0.89
36103147502,"Census Tract 1475.02, Suffolk County, New York",6374,5569,805,0.13,0.87
36103147503,"Census Tract 1475.03, Suffolk County, New York",1977,1732,245,0.12,0.88
36103147504,"Census Tract 1475.04, Suffolk County, New York",1543,1326,217,0.14,0.86
36103147505,"Census Tract 1475.05, Suffolk County, New York",6014,4672,1342,0.22,0.78
36103147601,"Census Tract 1476.01, Suffolk County, New York",2293,2096,197,0.09,0.91
36103147602,"Census Tract 1476.02, Suffolk County, New York",5256,4553,703,0.13,0.87
36103147701,"Census Tract 1477.01, Suffolk County, New York",3525,2987,538,0.15,0.85
36103147702,"Census Tract 1477.02, Suffolk County, New York",4781,4203,578,0.12,0.88
36103147802,"Census Tract 1478.02, Suffolk County, New York",3881,3400,481,0.12,0.88
36103147803,"Census Tract 1478.03, Suffolk County, New York",3190,2811,379,0.12,0.88
36103147804,"Census Tract 1478.04, Suffolk County, New York",5973,5291,682,0.11,0.89
36103147901,"Census Tract 1479.01, Suffolk County, New York",4209,3398,811,0.19,0.81
36103147902,"Census Tract 1479.02, Suffolk County, New York",4400,3903,497,0.11,0.89
36103158001,"Census Tract 1580.01, Suffolk County, New York",3795,3122,673,0.18,0.82
36103158009,"Census Tract 1580.09, Suffolk County, New York",2717,2132,585,0.22,0.78
36103158010,"Census Tract 1580.10, Suffolk County, New York",3680,2912,768,0.21,0.79
36103158011,"Census Tract 1580.11, Suffolk County, New York",4705,3460,1245,0.26,0.74
36103158012,"Census Tract 1580.12, Suffolk County, New York",3829,2769,1060,0.28,0.72
36103158013,"Census Tract 1580.13, Suffolk County, New York",2856,2121,735,0.26,0.74
36103158014,"Census Tract 1580.14, Suffolk County, New York",1066,200,866,0.81,0.19
36103158015,"Census Tract 1580.15, Suffolk County, New York",9343,2458,6885,0.74,0.26
36103158016,"Census Tract 1580.16, Suffolk County, New York",2137,1646,491,0.23,0.77
36103158017,"Census Tract 1580.17, Suffolk County, New York",4385,3520,865,0.2,0.8
36103158102,"Census Tract 1581.02, Suffolk County, New York",5053,3424,1629,0.32,0.68
36103158103,"Census Tract 1581.03, Suffolk County, New York",4343,2619,1724,0.4,0.6
36103158107,"Census Tract 1581.07, Suffolk County, New York",4211,3024,1187,0.28,0.72
36103158108,"Census Tract 1581.08, Suffolk County, New York",2879,1744,1135,0.39,0.61
36103158111,"Census Tract 1581.11, Suffolk County, New York",3087,2084,1003,0.32,0.68
36103158112,"Census Tract 1581.12, Suffolk County, New York",4263,2653,1610,0.38,0.62
36103158114,"Census Tract 1581.14, Suffolk County, New York",3364,2689,675,0.2,0.8
36103158116,"Census Tract 1581.16, Suffolk County, New York",1928,1326,602,0.31,0.69
36103158117,"Census Tract 1581.17, Suffolk County, New York",2872,1939,933,0.32,0.68
36103158118,"Census Tract 1581.18, Suffolk County, New York",3672,2857,815,0.22,0.78
36103158119,"Census Tract 1581.19, Suffolk County, New York",5740,4021,1719,0.3,0.7
36103158120,"Census Tract 1581.20, Suffolk County, New York",3188,2090,1098,0.34,0.66
36103158205,"Census Tract 1582.05, Suffolk County, New York",1713,1402,311,0.18,0.82
36103158206,"Census Tract 1582.06, Suffolk County, New York",3928,3066,862,0.22,0.78
36103158207,"Census Tract 1582.07, Suffolk County, New York",4842,3864,978,0.2,0.8
36103158208,"Census Tract 1582.08, Suffolk County, New York",4820,3544,1276,0.26,0.74
36103158209,"Census Tract 1582.09, Suffolk County, New York",3296,1862,1434,0.44,0.56
36103158304,"Census Tract 1583.04, Suffolk County, New York",6648,5810,838,0.13,0.87
36103158306,"Census Tract 1583.06, Suffolk County, New York",5948,4944,1004,0.17,0.83
36103158309,"Census Tract 1583.09, Suffolk County, New York",4615,2571,2044,0.44,0.56
36103158310,"Census Tract 1583.10, Suffolk County, New York",4557,3504,1053,0.23,0.77
36103158315,"Census Tract 1583.15, Suffolk County, New York",4502,2810,1692,0.38,0.62
36103158317,"Census Tract 1583.17, Suffolk County, New York",5674,4709,965,0.17,0.83
36103158318,"Census Tract 1583.18, Suffolk County, New York",4268,3543,725,0.17,0.83
36103158319,"Census Tract 1583.19, Suffolk County, New York",3790,2601,1189,0.31,0.69
36103158320,"Census Tract 1583.20, Suffolk County, New York",6172,4432,1740,0.28,0.72
36103158322,"Census Tract 1583.22, Suffolk County, New York",2029,1546,483,0.24,0.76
36103158324,"Census Tract 1583.24, Suffolk County, New York",3096,1963,1133,0.37,0.63
36103158325,"Census Tract 1583.25, Suffolk County, New York",6610,3585,3025,0.46,0.54
36103158326,"Census Tract 1583.26, Suffolk County, New York",1507,1042,465,0.31,0.69
36103158327,"Census Tract 1583.27, Suffolk County, New York",6601,4159,2442,0.37,0.63
36103158328,"Census Tract 1583.28, Suffolk County, New York",5281,4354,927,0.18,0.82
36103158329,"Census Tract 1583.29, Suffolk County, New York",1561,1362,199,0.13,0.87
36103158401,"Census Tract 1584.01, Suffolk County, New York",1255,1039,216,0.17,0.83
36103158402,"Census Tract 1584.02, Suffolk County, New York",4330,3703,627,0.14,0.86
36103158403,"Census Tract 1584.03, Suffolk County, New York",2375,1617,758,0.32,0.68
36103158407,"Census Tract 1584.07, Suffolk County, New York",5880,4753,1127,0.19,0.81
36103158408,"Census Tract 1584.08, Suffolk County, New York",3972,3140,832,0.21,0.79
36103158409,"Census Tract 1584.09, Suffolk County, New York",3762,2959,803,0.21,0.79
36103158410,"Census Tract 1584.10, Suffolk County, New York",3389,3164,225,0.07,0.93
36103158411,"Census Tract 1584.11, Suffolk County, New York",3072,2384,688,0.22,0.78
36103158412,"Census Tract 1584.12, Suffolk County, New York",2204,1860,344,0.16,0.84
36103158502,"Census Tract 1585.02, Suffolk County, New York",3373,2617,756,0.22,0.78
36103158505,"Census Tract 1585.05, Suffolk County, New York",3664,2705,959,0.26,0.74
36103158506,"Census Tract 1585.06, Suffolk County, New York",3197,2570,627,0.2,0.8
36103158509,"Census Tract 1585.09, Suffolk County, New York",4871,3193,1678,0.34,0.66
36103158510,"Census Tract 1585.10, Suffolk County, New York",6907,4722,2185,0.32,0.68
36103158511,"Census Tract 1585.11, Suffolk County, New York",6581,4681,1900,0.29,0.71
36103158512,"Census Tract 1585.12, Suffolk County, New York",3134,2537,597,0.19,0.81
36103158513,"Census Tract 1585.13, Suffolk County, New York",3065,2032,1033,0.34,0.66
36103158514,"Census Tract 1585.14, Suffolk County, New York",6613,4799,1814,0.27,0.73
36103158604,"Census Tract 1586.04, Suffolk County, New York",4866,3558,1308,0.27,0.73
36103158605,"Census Tract 1586.05, Suffolk County, New York",4945,3605,1340,0.27,0.73
36103158606,"Census Tract 1586.06, Suffolk County, New York",4996,3552,1444,0.29,0.71
36103158607,"Census Tract 1586.07, Suffolk County, New York",3241,2308,933,0.29,0.71
36103158608,"Census Tract 1586.08, Suffolk County, New York",4101,2559,1542,0.38,0.62
36103158609,"Census Tract 1586.09, Suffolk County, New York",4609,3269,1340,0.29,0.71
36103158705,"Census Tract 1587.05, Suffolk County, New York",3981,649,3332,0.84,0.16
36103158707,"Census Tract 1587.07, Suffolk County, New York",1796,1345,451,0.25,0.75
36103158708,"Census Tract 1587.08, Suffolk County, New York",3614,2105,1509,0.42,0.58
36103158709,"Census Tract 1587.09, Suffolk County, New York",2822,2204,618,0.22,0.78
36103158710,"Census Tract 1587.10, Suffolk County, New York",3949,2686,1263,0.32,0.68
36103158711,"Census Tract 1587.11, Suffolk County, New York",5736,3621,2115,0.37,0.63
36103158712,"Census Tract 1587.12, Suffolk County, New York",7744,4179,3565,0.46,0.54
36103158713,"Census Tract 1587.13, Suffolk County, New York",3004,758,2246,0.75,0.25
36103158714,"Census Tract 1587.14, Suffolk County, New York",2021,1122,899,0.44,0.56
36103158715,"Census Tract 1587.15, Suffolk County, New York",4482,2995,1487,0.33,0.67
36103158802,"Census Tract 1588.02, Suffolk County, New York",5156,4599,557,0.11,0.89
36103158803,"Census Tract 1588.03, Suffolk County, New York",5825,4380,1445,0.25,0.75
36103158805,"Census Tract 1588.05, Suffolk County, New York",3262,2274,988,0.3,0.7
36103158806,"Census Tract 1588.06, Suffolk County, New York",3505,2180,1325,0.38,0.62
36103158901,"Census Tract 1589.01, Suffolk County, New York",3183,2136,1047,0.33,0.67
36103158902,"Census Tract 1589.02, Suffolk County, New York",4595,2522,2073,0.45,0.55
36103159000,"Census Tract 1590, Suffolk County, New York",4614,2939,1675,0.36,0.64
36103159103,"Census Tract 1591.03, Suffolk County, New York",6292,1205,5087,0.81,0.19
36103159106,"Census Tract 1591.06, Suffolk County, New York",6120,3223,2897,0.47,0.53
36103159107,"Census Tract 1591.07, Suffolk County, New York",3711,2635,1076,0.29,0.71
36103159108,"Census Tract 1591.08, Suffolk County, New York",7056,4645,2411,0.34,0.66
36103159109,"Census Tract 1591.09, Suffolk County, New York",2902,1706,1196,0.41,0.59
36103159110,"Census Tract 1591.10, Suffolk County, New York",3578,2091,1487,0.42,0.58
36103159111,"Census Tract 1591.11, Suffolk County, New York",3159,2134,1025,0.32,0.68
36103159112,"Census Tract 1591.12, Suffolk County, New York",3810,2096,1714,0.45,0.55
36103159201,"Census Tract 1592.01, Suffolk County, New York",2830,1949,881,0.31,0.69
36103159203,"Census Tract 1592.03, Suffolk County, New York",5301,4321,980,0.18,0.82
36103159204,"Census Tract 1592.04, Suffolk County, New York",4174,3067,1107,0.27,0.73
36103159300,"Census Tract 1593, Suffolk County, New York",2203,1924,279,0.13,0.87
36103159406,"Census Tract 1594.06, Suffolk County, New York",5703,4149,1554,0.27,0.73
36103159407,"Census Tract 1594.07, Suffolk County, New York",6477,4209,2268,0.35,0.65
36103159408,"Census Tract 1594.08, Suffolk County, New York",3414,2199,1215,0.36,0.64
36103159410,"Census Tract 1594.10, Suffolk County, New York",8067,6254,1813,0.22,0.78
36103159411,"Census Tract 1594.11, Suffolk County, New York",3122,2304,818,0.26,0.74
36103159413,"Census Tract 1594.13, Suffolk County, New York",4821,4141,680,0.14,0.86
36103159414,"Census Tract 1594.14, Suffolk County, New York",3175,2443,732,0.23,0.77
36103159415,"Census Tract 1594.15, Suffolk County, New York",1883,1079,804,0.43,0.57
36103159416,"Census Tract 1594.16, Suffolk County, New York",5667,2666,3001,0.53,0.47
36103159509,"Census Tract 1595.09, Suffolk County, New York",3181,1624,1557,0.49,0.51
36103159510,"Census Tract 1595.10, Suffolk County, New York",359,247,112,0.31,0.69
36103159511,"Census Tract 1595.11, Suffolk County, New York",7051,3255,3796,0.54,0.46
36103159512,"Census Tract 1595.12, Suffolk County, New York",2312,1470,842,0.36,0.64
36103159513,"Census Tract 1595.13, Suffolk County, New York",4939,3149,1790,0.36,0.64
36103159514,"Census Tract 1595.14, Suffolk County, New York",3350,2104,1246,0.37,0.63
36103159515,"Census Tract 1595.15, Suffolk County, New York",2493,1655,838,0.34,0.66
36103159516,"Census Tract 1595.16, Suffolk County, New York",5173,2944,2229,0.43,0.57
36103159517,"Census Tract 1595.17, Suffolk County, New York",3572,2000,1572,0.44,0.56
36103159518,"Census Tract 1595.18, Suffolk County, New York",5648,3108,2540,0.45,0.55
36103159602,"Census Tract 1596.02, Suffolk County, New York",4060,3467,593,0.15,0.85
36103159603,"Census Tract 1596.03, Suffolk County, New York",1143,1022,121,0.11,0.89
36103159604,"Census Tract 1596.04, Suffolk County, New York",5058,4304,754,0.15,0.85
36103159700,"Census Tract 1597, Suffolk County, New York",2143,1741,402,0.19,0.81
36103169701,"Census Tract 1697.01, Suffolk County, New York",7731,6512,1219,0.16,0.84
36103169703,"Census Tract 1697.03, Suffolk County, New York",1546,1322,224,0.14,0.86
36103169705,"Census Tract 1697.05, Suffolk County, New York",2990,1773,1217,0.41,0.59
36103169706,"Census Tract 1697.06, Suffolk County, New York",4693,3656,1037,0.22,0.78
36103169800,"Census Tract 1698, Suffolk County, New York",7070,2394,4676,0.66,0.34
36103169903,"Census Tract 1699.03, Suffolk County, New York",4482,2708,1774,0.4,0.6
36103169904,"Census Tract 1699.04, Suffolk County, New York",1668,946,722,0.43,0.57
36103169905,"Census Tract 1699.05, Suffolk County, New York",1609,1381,228,0.14,0.86
36103169906,"Census Tract 1699.06, Suffolk County, New York",4113,3189,924,0.22,0.78
36103170003,"Census Tract 1700.03, Suffolk County, New York",2790,2310,480,0.17,0.83
36103170004,"Census Tract 1700.04, Suffolk County, New York",3027,2458,569,0.19,0.81
36103170005,"Census Tract 1700.05, Suffolk County, New York",2552,2284,268,0.11,0.89
36103170006,"Census Tract 1700.06, Suffolk County, New York",1909,1460,449,0.24,0.76
36103170101,"Census Tract 1701.01, Suffolk County, New York",2583,1300,1283,0.5,0.5
36103170203,"Census Tract 1702.03, Suffolk County, New York",1994,1572,422,0.21,0.79
36103170204,"Census Tract 1702.04, Suffolk County, New York",4112,3433,679,0.17,0.83
36103170205,"Census Tract 1702.05, Suffolk County, New York",2289,1730,559,0.24,0.76
36103170206,"Census Tract 1702.06, Suffolk County, New York",2476,2153,323,0.13,0.87
36103180300,"Census Tract 1803, Suffolk County, New York",3253,2777,476,0.15,0.85
36103190402,"Census Tract 1904.02, Suffolk County, New York",2650,1904,746,0.28,0.72
36103190403,"Census Tract 1904.03, Suffolk County, New York",3942,2212,1730,0.44,0.56
36103190404,"Census Tract 1904.04, Suffolk County, New York",3645,1316,2329,0.64,0.36
36103190405,"Census Tract 1904.05, Suffolk County, New York",5097,1707,3390,0.67,0.33
36103190502,"Census Tract 1905.02, Suffolk County, New York",3163,2323,840,0.27,0.73
36103190503,"Census Tract 1905.03, Suffolk County, New York",3871,3218,653,0.17,0.83
36103190504,"Census Tract 1905.04, Suffolk County, New York",2682,2182,500,0.19,0.81
36103190603,"Census Tract 1906.03, Suffolk County, New York",5201,3076,2125,0.41,0.59
36103190604,"Census Tract 1906.04, Suffolk County, New York",5066,2957,2109,0.42,0.58
36103190605,"Census Tract 1906.05, Suffolk County, New York",1662,1368,294,0.18,0.82
36103190606,"Census Tract 1906.06, Suffolk County, New York",4096,3117,979,0.24,0.76
36103190706,"Census Tract 1907.06, Suffolk County, New York",5245,3633,1612,0.31,0.69
36103190708,"Census Tract 1907.08, Suffolk County, New York",2580,2305,275,0.11,0.89
36103190709,"Census Tract 1907.09, Suffolk County, New York",3101,1432,1669,0.54,0.46
36103190710,"Census Tract 1907.10, Suffolk County, New York",1894,1106,788,0.42,0.58
36103190711,"Census Tract 1907.11, Suffolk County, New York",3951,3206,745,0.19,0.81
36103190712,"Census Tract 1907.12, Suffolk County, New York",1960,1639,321,0.16,0.84
36103190713,"Census Tract 1907.13, Suffolk County, New York",2245,1862,383,0.17,0.83
36103190714,"Census Tract 1907.14, Suffolk County, New York",3254,2351,903,0.28,0.72
36103190801,"Census Tract 1908.01, Suffolk County, New York",2263,1797,466,0.21,0.79
36103190802,"Census Tract 1908.02, Suffolk County, New York",2287,1421,866,0.38,0.62
36103200901,"Census Tract 2009.01, Suffolk County, New York",1500,1240,260,0.17,0.83
36103200903,"Census Tract 2009.03, Suffolk County, New York",2275,1558,717,0.32,0.68
36103200904,"Census Tract 2009.04, Suffolk County, New York",2701,1412,1289,0.48,0.52
36103200905,"Census Tract 2009.05, Suffolk County, New York",1941,1524,417,0.21,0.79
36103200906,"Census Tract 2009.06, Suffolk County, New York",2696,1854,842,0.31,0.69
36103201005,"Census Tract 2010.05, Suffolk County, New York",2676,1112,1564,0.58,0.42
36103201006,"Census Tract 2010.06, Suffolk County, New York",2192,1829,363,0.17,0.83
36103201007,"Census Tract 2010.07, Suffolk County, New York",2024,1536,488,0.24,0.76
36103201008,"Census Tract 2010.08, Suffolk County, New York",2294,1659,635,0.28,0.72
36103201009,"Census Tract 2010.09, Suffolk County, New York",5369,2931,2438,0.45,0.55
36103201010,"Census Tract 2010.10, Suffolk County, New York",2717,1952,765,0.28,0.72
36103201200,"Census Tract 2012, Suffolk County, New York",560,148,412,0.74,0.26
36103990100,"Census Tract 9901, Suffolk County, New York",0,0,0,0,0
36105950100,"Census Tract 9501, Sullivan County, New York",3366,2927,439,0.13,0.87
36105950201,"Census Tract 9502.01, Sullivan County, New York",2092,1675,417,0.2,0.8
36105950202,"Census Tract 9502.02, Sullivan County, New York",1198,1008,190,0.16,0.84
36105950300,"Census Tract 9503, Sullivan County, New York",1161,1014,147,0.13,0.87
36105950400,"Census Tract 9504, Sullivan County, New York",2989,2534,455,0.15,0.85
36105950500,"Census Tract 9505, Sullivan County, New York",3075,2093,982,0.32,0.68
36105950600,"Census Tract 9506, Sullivan County, New York",1652,1213,439,0.27,0.73
36105950701,"Census Tract 9507.01, Sullivan County, New York",3215,1582,1633,0.51,0.49
36105950702,"Census Tract 9507.02, Sullivan County, New York",2217,1024,1193,0.54,0.46
36105950801,"Census Tract 9508.01, Sullivan County, New York",2324,1540,784,0.34,0.66
36105950802,"Census Tract 9508.02, Sullivan County, New York",2251,1623,628,0.28,0.72
36105950900,"Census Tract 9509, Sullivan County, New York",3518,1641,1877,0.53,0.47
36105951000,"Census Tract 9510, Sullivan County, New York",2315,1119,1196,0.52,0.48
36105951100,"Census Tract 9511, Sullivan County, New York",3784,1663,2121,0.56,0.44
36105951201,"Census Tract 9512.01, Sullivan County, New York",4319,3350,969,0.22,0.78
36105951202,"Census Tract 9512.02, Sullivan County, New York",4214,3162,1052,0.25,0.75
36105951301,"Census Tract 9513.01, Sullivan County, New York",1756,1394,362,0.21,0.79
36105951302,"Census Tract 9513.02, Sullivan County, New York",2366,1727,639,0.27,0.73
36105951500,"Census Tract 9515, Sullivan County, New York",2898,1896,1002,0.35,0.65
36105951600,"Census Tract 9516, Sullivan County, New York",3400,1967,1433,0.42,0.58
36105951701,"Census Tract 9517.01, Sullivan County, New York",3443,2364,1079,0.31,0.69
36105951702,"Census Tract 9517.02, Sullivan County, New York",808,695,113,0.14,0.86
36105951801,"Census Tract 9518.01, Sullivan County, New York",3008,1261,1747,0.58,0.42
36105951802,"Census Tract 9518.02, Sullivan County, New York",3801,1057,2744,0.72,0.28
36105951900,"Census Tract 9519, Sullivan County, New York",1546,1114,432,0.28,0.72
36105952000,"Census Tract 9520, Sullivan County, New York",2413,2038,375,0.16,0.84
36105952100,"Census Tract 9521, Sullivan County, New York",2203,1779,424,0.19,0.81
36105952200,"Census Tract 9522, Sullivan County, New York",1448,1272,176,0.12,0.88
36105952300,"Census Tract 9523, Sullivan County, New York",1405,1197,208,0.15,0.85
36105952400,"Census Tract 9524, Sullivan County, New York",2196,1918,278,0.13,0.87
36105952500,"Census Tract 9525, Sullivan County, New York",2243,1844,399,0.18,0.82
36107020101,"Census Tract 201.01, Tioga County, New York",2523,2302,221,0.09,0.91
36107020102,"Census Tract 201.02, Tioga County, New York",3642,3351,291,0.08,0.92
36107020200,"Census Tract 202, Tioga County, New York",5149,4679,470,0.09,0.91
36107020300,"Census Tract 203, Tioga County, New York",6782,6090,692,0.1,0.9
36107020401,"Census Tract 204.01, Tioga County, New York",4425,4090,335,0.08,0.92
36107020402,"Census Tract 204.02, Tioga County, New York",3916,3542,374,0.1,0.9
36107020500,"Census Tract 205, Tioga County, New York",3654,3243,411,0.11,0.89
36107020600,"Census Tract 206, Tioga County, New York",6787,6274,513,0.08,0.92
36107020701,"Census Tract 207.01, Tioga County, New York",2968,2665,303,0.1,0.9
36107020702,"Census Tract 207.02, Tioga County, New York",4292,4026,266,0.06,0.94
36107020703,"Census Tract 207.03, Tioga County, New York",4317,3933,384,0.09,0.91
36109000100,"Census Tract 1, Tompkins County, New York",2064,1193,871,0.42,0.58
36109000201,"Census Tract 2.01, Tompkins County, New York",3337,1400,1937,0.58,0.42
36109000202,"Census Tract 2.02, Tompkins County, New York",2539,1513,1026,0.4,0.6
36109000300,"Census Tract 3, Tompkins County, New York",2780,1709,1071,0.39,0.61
36109000400,"Census Tract 4, Tompkins County, New York",4968,2880,2088,0.42,0.58
36109000500,"Census Tract 5, Tompkins County, New York",4489,2550,1939,0.43,0.57
36109000600,"Census Tract 6, Tompkins County, New York",5415,3675,1740,0.32,0.68
36109000700,"Census Tract 7, Tompkins County, New York",3641,2566,1075,0.3,0.7
36109000800,"Census Tract 8, Tompkins County, New York",2745,1754,991,0.36,0.64
36109000900,"Census Tract 9, Tompkins County, New York",4201,3201,1000,0.24,0.76
36109001000,"Census Tract 10, Tompkins County, New York",4530,2926,1604,0.35,0.65
36109001100,"Census Tract 11, Tompkins County, New York",6162,4762,1400,0.23,0.77
36109001200,"Census Tract 12, Tompkins County, New York",3324,2427,897,0.27,0.73
36109001301,"Census Tract 13.01, Tompkins County, New York",3445,1828,1617,0.47,0.53
36109001302,"Census Tract 13.02, Tompkins County, New York",3972,2503,1469,0.37,0.63
36109001400,"Census Tract 14, Tompkins County, New York",3595,2825,770,0.21,0.79
36109001500,"Census Tract 15, Tompkins County, New York",6321,4519,1802,0.29,0.71
36109001600,"Census Tract 16, Tompkins County, New York",4263,3729,534,0.13,0.87
36109001700,"Census Tract 17, Tompkins County, New York",4368,3699,669,0.15,0.85
36109001800,"Census Tract 18, Tompkins County, New York",4883,4136,747,0.15,0.85
36109001901,"Census Tract 19.01, Tompkins County, New York",3105,2622,483,0.16,0.84
36109001902,"Census Tract 19.02, Tompkins County, New York",3163,2648,515,0.16,0.84
36109002000,"Census Tract 20, Tompkins County, New York",4291,3521,770,0.18,0.82
36109002100,"Census Tract 21, Tompkins County, New York",4203,3539,664,0.16,0.84
36109002200,"Census Tract 22, Tompkins County, New York",4431,3873,558,0.13,0.87
36109002300,"Census Tract 23, Tompkins County, New York",5505,4739,766,0.14,0.86
36111950100,"Census Tract 9501, Ulster County, New York",5010,4345,665,0.13,0.87
36111950200,"Census Tract 9502, Ulster County, New York",3895,3085,810,0.21,0.79
36111950300,"Census Tract 9503, Ulster County, New York",4518,3671,847,0.19,0.81
36111950400,"Census Tract 9504, Ulster County, New York",4025,3468,557,0.14,0.86
36111950500,"Census Tract 9505, Ulster County, New York",3271,2710,561,0.17,0.83
36111950600,"Census Tract 9506, Ulster County, New York",3016,2615,401,0.13,0.87
36111950900,"Census Tract 9509, Ulster County, New York",1297,1083,214,0.16,0.84
36111951000,"Census Tract 9510, Ulster County, New York",4226,3640,586,0.14,0.86
36111951100,"Census Tract 9511, Ulster County, New York",2276,1994,282,0.12,0.88
36111951200,"Census Tract 9512, Ulster County, New York",3902,3293,609,0.16,0.84
36111951300,"Census Tract 9513, Ulster County, New York",4400,3368,1032,0.23,0.77
36111951400,"Census Tract 9514, Ulster County, New York",3640,2827,813,0.22,0.78
36111951500,"Census Tract 9515, Ulster County, New York",3454,2797,657,0.19,0.81
36111951600,"Census Tract 9516, Ulster County, New York",2099,1651,448,0.21,0.79
36111951700,"Census Tract 9517, Ulster County, New York",4712,2886,1826,0.39,0.61
36111951800,"Census Tract 9518, Ulster County, New York",1839,1125,714,0.39,0.61
36111951900,"Census Tract 9519, Ulster County, New York",2848,1690,1158,0.41,0.59
36111952000,"Census Tract 9520, Ulster County, New York",2815,1153,1662,0.59,0.41
36111952100,"Census Tract 9521, Ulster County, New York",3687,1762,1925,0.52,0.48
36111952200,"Census Tract 9522, Ulster County, New York",3761,2943,818,0.22,0.78
36111952300,"Census Tract 9523, Ulster County, New York",1717,1119,598,0.35,0.65
36111952400,"Census Tract 9524, Ulster County, New York",2690,1945,745,0.28,0.72
36111952500,"Census Tract 9525, Ulster County, New York",3527,2819,708,0.2,0.8
36111952600,"Census Tract 9526, Ulster County, New York",6021,5095,926,0.15,0.85
36111952700,"Census Tract 9527, Ulster County, New York",2699,2272,427,0.16,0.84
36111952800,"Census Tract 9528, Ulster County, New York",3083,2641,442,0.14,0.86
36111952901,"Census Tract 9529.01, Ulster County, New York",3063,2615,448,0.15,0.85
36111952902,"Census Tract 9529.02, Ulster County, New York",2595,2256,339,0.13,0.87
36111953000,"Census Tract 9530, Ulster County, New York",1815,1524,291,0.16,0.84
36111953300,"Census Tract 9533, Ulster County, New York",4372,3491,881,0.2,0.8
36111953400,"Census Tract 9534, Ulster County, New York",4843,3616,1227,0.25,0.75
36111953500,"Census Tract 9535, Ulster County, New York",5192,3139,2053,0.4,0.6
36111953600,"Census Tract 9536, Ulster County, New York",6116,4445,1671,0.27,0.73
36111953700,"Census Tract 9537, Ulster County, New York",5017,3984,1033,0.21,0.79
36111953800,"Census Tract 9538, Ulster County, New York",3801,2909,892,0.23,0.77
36111953900,"Census Tract 9539, Ulster County, New York",4911,3855,1056,0.22,0.78
36111954000,"Census Tract 9540, Ulster County, New York",5120,4007,1113,0.22,0.78
36111954100,"Census Tract 9541, Ulster County, New York",5304,3160,2144,0.4,0.6
36111954200,"Census Tract 9542, Ulster County, New York",5610,4657,953,0.17,0.83
36111954401,"Census Tract 9544.01, Ulster County, New York",4255,3048,1207,0.28,0.72
36111954402,"Census Tract 9544.02, Ulster County, New York",4734,3852,882,0.19,0.81
36111954500,"Census Tract 9545, Ulster County, New York",4219,2395,1824,0.43,0.57
36111954600,"Census Tract 9546, Ulster County, New York",1689,1255,434,0.26,0.74
36111954700,"Census Tract 9547, Ulster County, New York",1750,1242,508,0.29,0.71
36111954800,"Census Tract 9548, Ulster County, New York",5113,2409,2704,0.53,0.47
36111954900,"Census Tract 9549, Ulster County, New York",1590,1343,247,0.16,0.84
36111955001,"Census Tract 9550.01, Ulster County, New York",2382,2041,341,0.14,0.86
36111955002,"Census Tract 9550.02, Ulster County, New York",3075,2553,522,0.17,0.83
36111955300,"Census Tract 9553, Ulster County, New York",2283,1865,418,0.18,0.82
36111955400,"Census Tract 9554, Ulster County, New York",4574,3037,1537,0.34,0.66
36113070100,"Census Tract 701, Warren County, New York",2785,2460,325,0.12,0.88
36113070200,"Census Tract 702, Warren County, New York",1862,1542,320,0.17,0.83
36113070300,"Census Tract 703, Warren County, New York",3745,3345,400,0.11,0.89
36113070400,"Census Tract 704, Warren County, New York",3884,3419,465,0.12,0.88
36113070500,"Census Tract 705, Warren County, New York",2554,2192,362,0.14,0.86
36113070602,"Census Tract 706.02, Warren County, New York",1507,1404,103,0.07,0.93
36113070603,"Census Tract 706.03, Warren County, New York",3794,3351,443,0.12,0.88
36113070604,"Census Tract 706.04, Warren County, New York",2407,2188,219,0.09,0.91
36113070701,"Census Tract 707.01, Warren County, New York",4375,3882,493,0.11,0.89
36113070702,"Census Tract 707.02, Warren County, New York",4909,4426,483,0.1,0.9
36113070801,"Census Tract 708.01, Warren County, New York",3959,3557,402,0.1,0.9
36113070802,"Census Tract 708.02, Warren County, New York",3365,3041,324,0.1,0.9
36113070900,"Census Tract 709, Warren County, New York",4853,4464,389,0.08,0.92
36113071000,"Census Tract 710, Warren County, New York",3079,2826,253,0.08,0.92
36113072001,"Census Tract 720.01, Warren County, New York",2012,1804,208,0.1,0.9
36113072002,"Census Tract 720.02, Warren County, New York",1492,1383,109,0.07,0.93
36113073000,"Census Tract 730, Warren County, New York",3959,3643,316,0.08,0.92
36113073500,"Census Tract 735, Warren County, New York",1853,1705,148,0.08,0.92
36113074000,"Census Tract 740, Warren County, New York",2143,1971,172,0.08,0.92
36113075001,"Census Tract 750.01, Warren County, New York",1627,1511,116,0.07,0.93
36113075002,"Census Tract 750.02, Warren County, New York",1459,1335,124,0.08,0.92
36113076000,"Census Tract 760, Warren County, New York",2104,1986,118,0.06,0.94
36113078000,"Census Tract 780, Warren County, New York",2010,1864,146,0.07,0.93
36115080100,"Census Tract 801, Washington County, New York",4820,4197,623,0.13,0.87
36115080200,"Census Tract 802, Washington County, New York",2607,2313,294,0.11,0.89
36115080301,"Census Tract 803.01, Washington County, New York",3089,2757,332,0.11,0.89
36115080302,"Census Tract 803.02, Washington County, New York",2452,2260,192,0.08,0.92
36115081001,"Census Tract 810.01, Washington County, New York",1882,1752,130,0.07,0.93
36115081002,"Census Tract 810.02, Washington County, New York",3930,2108,1822,0.46,0.54
36115082001,"Census Tract 820.01, Washington County, New York",4880,4533,347,0.07,0.93
36115082002,"Census Tract 820.02, Washington County, New York",1104,1055,49,0.04,0.96
36115084001,"Census Tract 840.01, Washington County, New York",3179,3006,173,0.05,0.95
36115084002,"Census Tract 840.02, Washington County, New York",3036,2841,195,0.06,0.94
36115085000,"Census Tract 850, Washington County, New York",2193,2015,178,0.08,0.92
36115086000,"Census Tract 860, Washington County, New York",1786,1656,130,0.07,0.93
36115087000,"Census Tract 870, Washington County, New York",3644,3346,298,0.08,0.92
36115088001,"Census Tract 880.01, Washington County, New York",2379,2158,221,0.09,0.91
36115088002,"Census Tract 880.02, Washington County, New York",3612,3261,351,0.1,0.9
36115089000,"Census Tract 890, Washington County, New York",4868,4496,372,0.08,0.92
36115090000,"Census Tract 900, Washington County, New York",2612,2366,246,0.09,0.91
36115091000,"Census Tract 910, Washington County, New York",1718,1583,135,0.08,0.92
36115092000,"Census Tract 920, Washington County, New York",3280,3017,263,0.08,0.92
36115093000,"Census Tract 930, Washington County, New York",1952,1794,158,0.08,0.92
36115094000,"Census Tract 940, Washington County, New York",2279,2091,188,0.08,0.92
36117020103,"Census Tract 201.03, Wayne County, New York",2675,2453,222,0.08,0.92
36117020104,"Census Tract 201.04, Wayne County, New York",2502,2323,179,0.07,0.93
36117020105,"Census Tract 201.05, Wayne County, New York",2947,2679,268,0.09,0.91
36117020106,"Census Tract 201.06, Wayne County, New York",2322,2071,251,0.11,0.89
36117020201,"Census Tract 202.01, Wayne County, New York",4722,4303,419,0.09,0.91
36117020202,"Census Tract 202.02, Wayne County, New York",4531,4160,371,0.08,0.92
36117020302,"Census Tract 203.02, Wayne County, New York",5372,4870,502,0.09,0.91
36117020303,"Census Tract 203.03, Wayne County, New York",3898,3467,431,0.11,0.89
36117020401,"Census Tract 204.01, Wayne County, New York",2897,2546,351,0.12,0.88
36117020402,"Census Tract 204.02, Wayne County, New York",3963,3347,616,0.16,0.84
36117020500,"Census Tract 205, Wayne County, New York",4566,4100,466,0.1,0.9
36117020601,"Census Tract 206.01, Wayne County, New York",1568,1464,104,0.07,0.93
36117020602,"Census Tract 206.02, Wayne County, New York",2402,2153,249,0.1,0.9
36117020700,"Census Tract 207, Wayne County, New York",3433,3052,381,0.11,0.89
36117020800,"Census Tract 208, Wayne County, New York",2909,2397,512,0.18,0.82
36117020900,"Census Tract 209, Wayne County, New York",5119,3717,1402,0.27,0.73
36117021000,"Census Tract 210, Wayne County, New York",6121,5510,611,0.1,0.9
36117021100,"Census Tract 211, Wayne County, New York",5084,4012,1072,0.21,0.79
36117021200,"Census Tract 212, Wayne County, New York",4533,3452,1081,0.24,0.76
36117021400,"Census Tract 214, Wayne County, New York",3672,2742,930,0.25,0.75
36117021501,"Census Tract 215.01, Wayne County, New York",1872,1684,188,0.1,0.9
36117021502,"Census Tract 215.02, Wayne County, New York",4002,3629,373,0.09,0.91
36117021600,"Census Tract 216, Wayne County, New York",4126,3756,370,0.09,0.91
36117021700,"Census Tract 217, Wayne County, New York",3876,3527,349,0.09,0.91
36117021800,"Census Tract 218, Wayne County, New York",2171,1816,355,0.16,0.84
36117990100,"Census Tract 9901, Wayne County, New York",0,0,0,0,0
36119000101,"Census Tract 1.01, Westchester County, New York",5731,225,5506,0.96,0.04
36119000103,"Census Tract 1.03, Westchester County, New York",5850,321,5529,0.95,0.05
36119000104,"Census Tract 1.04, Westchester County, New York",1016,274,742,0.73,0.27
36119000202,"Census Tract 2.02, Westchester County, New York",3905,668,3237,0.83,0.17
36119000203,"Census Tract 2.03, Westchester County, New York",3365,1117,2248,0.67,0.33
36119000204,"Census Tract 2.04, Westchester County, New York",4108,137,3971,0.97,0.03
36119000205,"Census Tract 2.05, Westchester County, New York",3928,203,3725,0.95,0.05
36119000300,"Census Tract 3, Westchester County, New York",4638,172,4466,0.96,0.04
36119000401,"Census Tract 4.01, Westchester County, New York",6059,700,5359,0.88,0.12
36119000403,"Census Tract 4.03, Westchester County, New York",3740,125,3615,0.97,0.03
36119000404,"Census Tract 4.04, Westchester County, New York",2239,195,2044,0.91,0.09
36119000501,"Census Tract 5.01, Westchester County, New York",2477,106,2371,0.96,0.04
36119000502,"Census Tract 5.02, Westchester County, New York",3544,111,3433,0.97,0.03
36119000601,"Census Tract 6.01, Westchester County, New York",2878,345,2533,0.88,0.12
36119000602,"Census Tract 6.02, Westchester County, New York",4478,560,3918,0.87,0.13
36119000701,"Census Tract 7.01, Westchester County, New York",3455,1410,2045,0.59,0.41
36119000702,"Census Tract 7.02, Westchester County, New York",5272,1611,3661,0.69,0.31
36119000801,"Census Tract 8.01, Westchester County, New York",5950,2737,3213,0.54,0.46
36119000802,"Census Tract 8.02, Westchester County, New York",2646,864,1782,0.67,0.33
36119000803,"Census Tract 8.03, Westchester County, New York",4786,1542,3244,0.68,0.32
36119000900,"Census Tract 9, Westchester County, New York",3607,1435,2172,0.6,0.4
36119001000,"Census Tract 10, Westchester County, New York",1820,177,1643,0.9,0.1
36119001101,"Census Tract 11.01, Westchester County, New York",3907,229,3678,0.94,0.06
36119001102,"Census Tract 11.02, Westchester County, New York",5598,727,4871,0.87,0.13
36119001200,"Census Tract 12, Westchester County, New York",5336,541,4795,0.9,0.1
36119001301,"Census Tract 13.01, Westchester County, New York",3883,1058,2825,0.73,0.27
36119001302,"Census Tract 13.02, Westchester County, New York",4101,577,3524,0.86,0.14
36119001304,"Census Tract 13.04, Westchester County, New York",3630,305,3325,0.92,0.08
36119001305,"Census Tract 13.05, Westchester County, New York",3505,222,3283,0.94,0.06
36119001401,"Census Tract 14.01, Westchester County, New York",4244,2246,1998,0.47,0.53
36119001402,"Census Tract 14.02, Westchester County, New York",2003,1292,711,0.35,0.65
36119001403,"Census Tract 14.03, Westchester County, New York",3353,1461,1892,0.56,0.44
36119001502,"Census Tract 15.02, Westchester County, New York",3189,1899,1290,0.4,0.6
36119001503,"Census Tract 15.03, Westchester County, New York",3167,2247,920,0.29,0.71
36119001504,"Census Tract 15.04, Westchester County, New York",5020,2810,2210,0.44,0.56
36119001505,"Census Tract 15.05, Westchester County, New York",2194,815,1379,0.63,0.37
36119001600,"Census Tract 16, Westchester County, New York",4105,1313,2792,0.68,0.32
36119001701,"Census Tract 17.01, Westchester County, New York",3913,1787,2126,0.54,0.46
36119001702,"Census Tract 17.02, Westchester County, New York",3125,1873,1252,0.4,0.6
36119001800,"Census Tract 18, Westchester County, New York",1803,192,1611,0.89,0.11
36119001900,"Census Tract 19, Westchester County, New York",1753,879,874,0.5,0.5
36119002000,"Census Tract 20, Westchester County, New York",4545,2474,2071,0.46,0.54
36119002101,"Census Tract 21.01, Westchester County, New York",4035,1936,2099,0.52,0.48
36119002103,"Census Tract 21.03, Westchester County, New York",3258,2748,510,0.16,0.84
36119002104,"Census Tract 21.04, Westchester County, New York",5290,2440,2850,0.54,0.46
36119002105,"Census Tract 21.05, Westchester County, New York",1926,1308,618,0.32,0.68
36119002106,"Census Tract 21.06, Westchester County, New York",2602,396,2206,0.85,0.15
36119002107,"Census Tract 21.07, Westchester County, New York",1592,685,907,0.57,0.43
36119002201,"Census Tract 22.01, Westchester County, New York",2374,1502,872,0.37,0.63
36119002202,"Census Tract 22.02, Westchester County, New York",4709,3462,1247,0.26,0.74
36119002203,"Census Tract 22.03, Westchester County, New York",1645,908,737,0.45,0.55
36119002204,"Census Tract 22.04, Westchester County, New York",5144,3499,1645,0.32,0.68
36119002300,"Census Tract 23, Westchester County, New York",3930,2241,1689,0.43,0.57
36119002401,"Census Tract 24.01, Westchester County, New York",1908,966,942,0.49,0.51
36119002402,"Census Tract 24.02, Westchester County, New York",3418,1547,1871,0.55,0.45
36119002403,"Census Tract 24.03, Westchester County, New York",5891,2519,3372,0.57,0.43
36119002404,"Census Tract 24.04, Westchester County, New York",2924,1271,1653,0.57,0.43
36119002405,"Census Tract 24.05, Westchester County, New York",3057,1560,1497,0.49,0.51
36119002600,"Census Tract 26, Westchester County, New York",4349,109,4240,0.97,0.03
36119002700,"Census Tract 27, Westchester County, New York",3757,36,3721,0.99,0.01
36119002800,"Census Tract 28, Westchester County, New York",2732,28,2704,0.99,0.01
36119002900,"Census Tract 29, Westchester County, New York",4273,40,4233,0.99,0.01
36119003000,"Census Tract 30, Westchester County, New York",3228,63,3165,0.98,0.02
36119003100,"Census Tract 31, Westchester County, New York",3211,115,3096,0.96,0.04
36119003200,"Census Tract 32, Westchester County, New York",2954,73,2881,0.98,0.02
36119003300,"Census Tract 33, Westchester County, New York",3993,70,3923,0.98,0.02
36119003400,"Census Tract 34, Westchester County, New York",4912,158,4754,0.97,0.03
36119003500,"Census Tract 35, Westchester County, New York",2354,114,2240,0.95,0.05
36119003600,"Census Tract 36, Westchester County, New York",4499,361,4138,0.92,0.08
36119003700,"Census Tract 37, Westchester County, New York",4307,638,3669,0.85,0.15
36119003800,"Census Tract 38, Westchester County, New York",3342,1207,2135,0.64,0.36
36119003900,"Census Tract 39, Westchester County, New York",3801,1285,2516,0.66,0.34
36119004001,"Census Tract 40.01, Westchester County, New York",3834,236,3598,0.94,0.06
36119004002,"Census Tract 40.02, Westchester County, New York",2959,366,2593,0.88,0.12
36119004100,"Census Tract 41, Westchester County, New York",3703,259,3444,0.93,0.07
36119004200,"Census Tract 42, Westchester County, New York",4879,895,3984,0.82,0.18
36119004500,"Census Tract 45, Westchester County, New York",1548,695,853,0.55,0.45
36119004600,"Census Tract 46, Westchester County, New York",3155,2400,755,0.24,0.76
36119004700,"Census Tract 47, Westchester County, New York",3501,2923,578,0.17,0.83
36119004801,"Census Tract 48.01, Westchester County, New York",3693,2425,1268,0.34,0.66
36119004802,"Census Tract 48.02, Westchester County, New York",3391,2108,1283,0.38,0.62
36119004900,"Census Tract 49, Westchester County, New York",3275,2403,872,0.27,0.73
36119005001,"Census Tract 50.01, Westchester County, New York",3738,2692,1046,0.28,0.72
36119005002,"Census Tract 50.02, Westchester County, New York",4572,3690,882,0.19,0.81
36119005100,"Census Tract 51, Westchester County, New York",4337,3102,1235,0.28,0.72
36119005200,"Census Tract 52, Westchester County, New York",4979,4109,870,0.17,0.83
36119005300,"Census Tract 53, Westchester County, New York",5355,3112,2243,0.42,0.58
36119005400,"Census Tract 54, Westchester County, New York",1971,1527,444,0.23,0.77
36119005500,"Census Tract 55, Westchester County, New York",5752,4391,1361,0.24,0.76
36119005600,"Census Tract 56, Westchester County, New York",0,0,0,0,0
36119005702,"Census Tract 57.02, Westchester County, New York",3266,1450,1816,0.56,0.44
36119005703,"Census Tract 57.03, Westchester County, New York",3291,1563,1728,0.53,0.47
36119005704,"Census Tract 57.04, Westchester County, New York",3172,1494,1678,0.53,0.47
36119005800,"Census Tract 58, Westchester County, New York",4181,1005,3176,0.76,0.24
36119005901,"Census Tract 59.01, Westchester County, New York",5138,1217,3921,0.76,0.24
36119005902,"Census Tract 59.02, Westchester County, New York",5654,2666,2988,0.53,0.47
36119006000,"Census Tract 60, Westchester County, New York",4335,1480,2855,0.66,0.34
36119006100,"Census Tract 61, Westchester County, New York",4099,997,3102,0.76,0.24
36119006200,"Census Tract 62, Westchester County, New York",5796,887,4909,0.85,0.15
36119006301,"Census Tract 63.01, Westchester County, New York",3713,454,3259,0.88,0.12
36119006302,"Census Tract 63.02, Westchester County, New York",3114,446,2668,0.86,0.14
36119006400,"Census Tract 64, Westchester County, New York",5504,776,4728,0.86,0.14
36119006500,"Census Tract 65, Westchester County, New York",5762,1365,4397,0.76,0.24
36119006600,"Census Tract 66, Westchester County, New York",6406,3877,2529,0.39,0.61
36119006700,"Census Tract 67, Westchester County, New York",5214,4025,1189,0.23,0.77
36119006801,"Census Tract 68.01, Westchester County, New York",5595,4260,1335,0.24,0.76
36119006802,"Census Tract 68.02, Westchester County, New York",5486,4047,1439,0.26,0.74
36119006900,"Census Tract 69, Westchester County, New York",6249,4684,1565,0.25,0.75
36119007000,"Census Tract 70, Westchester County, New York",6601,5305,1296,0.2,0.8
36119007100,"Census Tract 71, Westchester County, New York",6630,5259,1371,0.21,0.79
36119007200,"Census Tract 72, Westchester County, New York",7022,4589,2433,0.35,0.65
36119007300,"Census Tract 73, Westchester County, New York",5256,2253,3003,0.57,0.43
36119007401,"Census Tract 74.01, Westchester County, New York",4849,2814,2035,0.42,0.58
36119007402,"Census Tract 74.02, Westchester County, New York",3024,2317,707,0.23,0.77
36119007500,"Census Tract 75, Westchester County, New York",5056,4015,1041,0.21,0.79
36119007600,"Census Tract 76, Westchester County, New York",6555,5441,1114,0.17,0.83
36119007700,"Census Tract 77, Westchester County, New York",4981,3596,1385,0.28,0.72
36119007800,"Census Tract 78, Westchester County, New York",4761,531,4230,0.89,0.11
36119007901,"Census Tract 79.01, Westchester County, New York",3620,746,2874,0.79,0.21
36119007902,"Census Tract 79.02, Westchester County, New York",5089,753,4336,0.85,0.15
36119008000,"Census Tract 80, Westchester County, New York",5963,647,5316,0.89,0.11
36119008100,"Census Tract 81, Westchester County, New York",5026,1362,3664,0.73,0.27
36119008200,"Census Tract 82, Westchester County, New York",7401,3975,3426,0.46,0.54
36119008301,"Census Tract 83.01, Westchester County, New York",2779,1341,1438,0.52,0.48
36119008302,"Census Tract 83.02, Westchester County, New York",7101,5730,1371,0.19,0.81
36119008401,"Census Tract 84.01, Westchester County, New York",2233,1849,384,0.17,0.83
36119008403,"Census Tract 84.03, Westchester County, New York",3883,2457,1426,0.37,0.63
36119008404,"Census Tract 84.04, Westchester County, New York",5111,3191,1920,0.38,0.62
36119008500,"Census Tract 85, Westchester County, New York",3726,3122,604,0.16,0.84
36119008602,"Census Tract 86.02, Westchester County, New York",5387,3379,2008,0.37,0.63
36119008700,"Census Tract 87, Westchester County, New York",5745,3657,2088,0.36,0.64
36119008801,"Census Tract 88.01, Westchester County, New York",2031,435,1596,0.79,0.21
36119008802,"Census Tract 88.02, Westchester County, New York",2637,1179,1458,0.55,0.45
36119008901,"Census Tract 89.01, Westchester County, New York",5676,2739,2937,0.52,0.48
36119008902,"Census Tract 89.02, Westchester County, New York",3827,1274,2553,0.67,0.33
36119009000,"Census Tract 90, Westchester County, New York",4199,1485,2714,0.65,0.35
36119009100,"Census Tract 91, Westchester County, New York",5811,1234,4577,0.79,0.21
36119009201,"Census Tract 92.01, Westchester County, New York",4265,1211,3054,0.72,0.28
36119009202,"Census Tract 92.02, Westchester County, New York",3212,578,2634,0.82,0.18
36119009300,"Census Tract 93, Westchester County, New York",3679,1027,2652,0.72,0.28
36119009400,"Census Tract 94, Westchester County, New York",4290,1298,2992,0.7,0.3
36119009500,"Census Tract 95, Westchester County, New York",5175,2292,2883,0.56,0.44
36119009600,"Census Tract 96, Westchester County, New York",4541,3557,984,0.22,0.78
36119009701,"Census Tract 97.01, Westchester County, New York",3100,2340,760,0.25,0.75
36119009702,"Census Tract 97.02, Westchester County, New York",2826,2222,604,0.21,0.79
36119009703,"Census Tract 97.03, Westchester County, New York",4290,3371,919,0.21,0.79
36119009800,"Census Tract 98, Westchester County, New York",4815,3320,1495,0.31,0.69
36119009900,"Census Tract 99, Westchester County, New York",3126,2254,872,0.28,0.72
36119010000,"Census Tract 100, Westchester County, New York",5616,3791,1825,0.32,0.68
36119010100,"Census Tract 101, Westchester County, New York",4696,2884,1812,0.39,0.61
36119010200,"Census Tract 102, Westchester County, New York",5273,4045,1228,0.23,0.77
36119010300,"Census Tract 103, Westchester County, New York",3317,2332,985,0.3,0.7
36119010400,"Census Tract 104, Westchester County, New York",3913,2635,1278,0.33,0.67
36119010500,"Census Tract 105, Westchester County, New York",7628,5113,2515,0.33,0.67
36119010600,"Census Tract 106, Westchester County, New York",5091,3242,1849,0.36,0.64
36119010701,"Census Tract 107.01, Westchester County, New York",6372,3609,2763,0.43,0.57
36119010702,"Census Tract 107.02, Westchester County, New York",5479,3117,2362,0.43,0.57
36119010801,"Census Tract 108.01, Westchester County, New York",3381,1923,1458,0.43,0.57
36119010803,"Census Tract 108.03, Westchester County, New York",3770,1992,1778,0.47,0.53
36119010804,"Census Tract 108.04, Westchester County, New York",2591,1518,1073,0.41,0.59
36119010901,"Census Tract 109.01, Westchester County, New York",2368,1217,1151,0.49,0.51
36119010902,"Census Tract 109.02, Westchester County, New York",5938,1661,4277,0.72,0.28
36119010903,"Census Tract 109.03, Westchester County, New York",5084,825,4259,0.84,0.16
36119011000,"Census Tract 110, Westchester County, New York",2473,610,1863,0.75,0.25
36119011101,"Census Tract 111.01, Westchester County, New York",6551,3316,3235,0.49,0.51
36119011102,"Census Tract 111.02, Westchester County, New York",3106,1946,1160,0.37,0.63
36119011200,"Census Tract 112, Westchester County, New York",4550,1053,3497,0.77,0.23
36119011300,"Census Tract 113, Westchester County, New York",6652,5128,1524,0.23,0.77
36119011401,"Census Tract 114.01, Westchester County, New York",4302,2969,1333,0.31,0.69
36119011402,"Census Tract 114.02, Westchester County, New York",2172,1324,848,0.39,0.61
36119011500,"Census Tract 115, Westchester County, New York",5386,2725,2661,0.49,0.51
36119011601,"Census Tract 116.01, Westchester County, New York",3188,509,2679,0.84,0.16
36119011602,"Census Tract 116.02, Westchester County, New York",3431,730,2701,0.79,0.21
36119011700,"Census Tract 117, Westchester County, New York",2966,2212,754,0.25,0.75
36119011800,"Census Tract 118, Westchester County, New York",6722,5052,1670,0.25,0.75
36119011902,"Census Tract 119.02, Westchester County, New York",4528,3260,1268,0.28,0.72
36119012000,"Census Tract 120, Westchester County, New York",4625,3781,844,0.18,0.82
36119012101,"Census Tract 121.01, Westchester County, New York",5683,4712,971,0.17,0.83
36119012102,"Census Tract 121.02, Westchester County, New York",4659,3627,1032,0.22,0.78
36119012201,"Census Tract 122.01, Westchester County, New York",3180,2381,799,0.25,0.75
36119012202,"Census Tract 122.02, Westchester County, New York",4333,3143,1190,0.27,0.73
36119012301,"Census Tract 123.01, Westchester County, New York",2401,1171,1230,0.51,0.49
36119012303,"Census Tract 123.03, Westchester County, New York",5114,4203,911,0.18,0.82
36119012304,"Census Tract 123.04, Westchester County, New York",4893,4137,756,0.15,0.85
36119012400,"Census Tract 124, Westchester County, New York",5082,4264,818,0.16,0.84
36119012501,"Census Tract 125.01, Westchester County, New York",3032,2447,585,0.19,0.81
36119012502,"Census Tract 125.02, Westchester County, New York",5561,4617,944,0.17,0.83
36119012503,"Census Tract 125.03, Westchester County, New York",3672,3043,629,0.17,0.83
36119012600,"Census Tract 126, Westchester County, New York",4529,3702,827,0.18,0.82
36119012700,"Census Tract 127, Westchester County, New York",4643,3865,778,0.17,0.83
36119012803,"Census Tract 128.03, Westchester County, New York",2976,2344,632,0.21,0.79
36119012804,"Census Tract 128.04, Westchester County, New York",4123,2090,2033,0.49,0.51
36119012900,"Census Tract 129, Westchester County, New York",4389,1518,2871,0.65,0.35
36119013000,"Census Tract 130, Westchester County, New York",6570,3558,3012,0.46,0.54
36119013102,"Census Tract 131.02, Westchester County, New York",6390,4687,1703,0.27,0.73
36119013103,"Census Tract 131.03, Westchester County, New York",5324,3876,1448,0.27,0.73
36119013104,"Census Tract 131.04, Westchester County, New York",6597,5261,1336,0.2,0.8
36119013201,"Census Tract 132.01, Westchester County, New York",3753,2888,865,0.23,0.77
36119013202,"Census Tract 132.02, Westchester County, New York",3131,2360,771,0.25,0.75
36119013301,"Census Tract 133.01, Westchester County, New York",3991,867,3124,0.78,0.22
36119013304,"Census Tract 133.04, Westchester County, New York",5391,1202,4189,0.78,0.22
36119013401,"Census Tract 134.01, Westchester County, New York",3208,1193,2015,0.63,0.37
36119013402,"Census Tract 134.02, Westchester County, New York",4213,1501,2712,0.64,0.36
36119013500,"Census Tract 135, Westchester County, New York",4060,1895,2165,0.53,0.47
36119013600,"Census Tract 136, Westchester County, New York",5321,2011,3310,0.62,0.38
36119013700,"Census Tract 137, Westchester County, New York",5626,3880,1746,0.31,0.69
36119013800,"Census Tract 138, Westchester County, New York",3384,2625,759,0.22,0.78
36119013900,"Census Tract 139, Westchester County, New York",4943,3436,1507,0.3,0.7
36119014000,"Census Tract 140, Westchester County, New York",2302,1479,823,0.36,0.64
36119014100,"Census Tract 141, Westchester County, New York",6525,2100,4425,0.68,0.32
36119014200,"Census Tract 142, Westchester County, New York",3994,1068,2926,0.73,0.27
36119014300,"Census Tract 143, Westchester County, New York",4240,554,3686,0.87,0.13
36119014400,"Census Tract 144, Westchester County, New York",5942,1589,4353,0.73,0.27
36119014500,"Census Tract 145, Westchester County, New York",4730,2409,2321,0.49,0.51
36119014604,"Census Tract 146.04, Westchester County, New York",4363,2931,1432,0.33,0.67
36119014605,"Census Tract 146.05, Westchester County, New York",2933,1931,1002,0.34,0.66
36119014606,"Census Tract 146.06, Westchester County, New York",5964,4583,1381,0.23,0.77
36119014607,"Census Tract 146.07, Westchester County, New York",4447,2873,1574,0.35,0.65
36119014701,"Census Tract 147.01, Westchester County, New York",4977,2873,2104,0.42,0.58
36119014703,"Census Tract 147.03, Westchester County, New York",6287,3671,2616,0.42,0.58
36119014704,"Census Tract 147.04, Westchester County, New York",2164,1155,1009,0.47,0.53
36119014805,"Census Tract 148.05, Westchester County, New York",4449,3409,1040,0.23,0.77
36119014806,"Census Tract 148.06, Westchester County, New York",6591,4804,1787,0.27,0.73
36119014808,"Census Tract 148.08, Westchester County, New York",3382,2600,782,0.23,0.77
36119014809,"Census Tract 148.09, Westchester County, New York",6255,4630,1625,0.26,0.74
36119014810,"Census Tract 148.10, Westchester County, New York",2117,1729,388,0.18,0.82
36119014811,"Census Tract 148.11, Westchester County, New York",5736,4324,1412,0.25,0.75
36119014812,"Census Tract 148.12, Westchester County, New York",4324,3059,1265,0.29,0.71
36119014813,"Census Tract 148.13, Westchester County, New York",3715,2351,1364,0.37,0.63
36119014901,"Census Tract 149.01, Westchester County, New York",6280,5232,1048,0.17,0.83
36119014903,"Census Tract 149.03, Westchester County, New York",4006,3550,456,0.11,0.89
36119014907,"Census Tract 149.07, Westchester County, New York",4176,3267,909,0.22,0.78
36119014908,"Census Tract 149.08, Westchester County, New York",3673,2935,738,0.2,0.8
36119014909,"Census Tract 149.09, Westchester County, New York",3406,2928,478,0.14,0.86
36119015000,"Census Tract 150, Westchester County, New York",5243,4270,973,0.19,0.81
36119015100,"Census Tract 151, Westchester County, New York",5258,2329,2929,0.56,0.44
36119981000,"Census Tract 9810, Westchester County, New York",1121,523,598,0.53,0.47
36119982000,"Census Tract 9820, Westchester County, New York",1367,135,1232,0.9,0.1
36119983000,"Census Tract 9830, Westchester County, New York",1038,423,615,0.59,0.41
36119984000,"Census Tract 9840, Westchester County, New York",781,384,397,0.51,0.49
36119985000,"Census Tract 9850, Westchester County, New York",2133,1125,1008,0.47,0.53
36121970100,"Census Tract 9701, Wyoming County, New York",2592,2430,162,0.06,0.94
36121970201,"Census Tract 9702.01, Wyoming County, New York",2090,504,1586,0.76,0.24
36121970202,"Census Tract 9702.02, Wyoming County, New York",3700,3473,227,0.06,0.94
36121970300,"Census Tract 9703, Wyoming County, New York",3235,3100,135,0.04,0.96
36121970400,"Census Tract 9704, Wyoming County, New York",3650,3462,188,0.05,0.95
36121970500,"Census Tract 9705, Wyoming County, New York",5316,4850,466,0.09,0.91
36121970600,"Census Tract 9706, Wyoming County, New York",5832,4490,1342,0.23,0.77
36121970700,"Census Tract 9707, Wyoming County, New York",2711,2493,218,0.08,0.92
36121970800,"Census Tract 9708, Wyoming County, New York",2764,2594,170,0.06,0.94
36121970900,"Census Tract 9709, Wyoming County, New York",1972,1881,91,0.05,0.95
36121971000,"Census Tract 9710, Wyoming County, New York",4187,3971,216,0.05,0.95
36121971100,"Census Tract 9711, Wyoming County, New York",2482,2331,151,0.06,0.94
36123150101,"Census Tract 1501.01, Yates County, New York",3441,3188,253,0.07,0.93
36123150102,"Census Tract 1501.02, Yates County, New York",2259,2100,159,0.07,0.93
36123150200,"Census Tract 1502, Yates County, New York",5791,5360,431,0.07,0.93
36123150301,"Census Tract 1503.01, Yates County, New York",2854,2691,163,0.06,0.94
36123150302,"Census Tract 1503.02, Yates County, New York",2296,2164,132,0.06,0.94
36123150400,"Census Tract 1504, Yates County, New York",3836,3526,310,0.08,0.92
36123150501,"Census Tract 1505.01, Yates County, New York",1815,1640,175,0.1,0.9
36123150502,"Census Tract 1505.02, Yates County, New York",2482,2380,102,0.04,0.96
